ба	у
ба-	т
баадаб	с
баайни	р
бабақ	о
баб-баравар	с
баббит	о
бавосир	о
бавосита	р
багаж	о
багажник	о
бад	с
бад-	с
бадавий	с
бадавлат	с
бадавлатлик	о
бадал	о
бадалида	к
бадан	о
бадантарбия	о
бадар	о
бадарға	о
бадастир	с
бадахлоқ	с
бадбахт	с
бадбахтлик	о
бадбашара	с
бадбин	с,р
бадбинлик	о
бадбуруш	с
бадбўй	с
бадбўйлик	о
бадгир	с
бадгумон	с
бадгумонлик	о
бадгўй	с
баджаҳл	с
баджаҳллик	о
бадзабон	с
бадзот	с
бадиа	c,о
бадииёт	о
бадиий	с
бадиийлик	о
бадиият	о
бадик	с,о
бадикхон	о
бадикчи	о
бадиҳа	о
бадиҳагўй	о
бадиҳагўйлик	о
бадкарда	о
бадкир	с,о
бадкирдор	о
бадкирдорлик	о
бадкор	о,с
бадкорлик	о
бадланмоқ	ф
бадмаст	с
бадмастлик	о
бадминтон	о
баднамо	с
баднафас	с
баднафс	с
баднафслик	о
бадният	о
бадном	с
бадномлик	о
баднусха	с
бадранг	с
бадраф	о
бадрафхона	о
бадрашк	с
бадрўй	с
бадсурат	с
бадтар	с
бадтарин	с
бадтарлашмоқ	ф
бадфеъл	с
бадфеъллик	о
бадхаёл	о
бадхат	с
бадхоҳ	с
бадхоҳлик	о
бадхулқ	с
бадхўй	с
бадхўр	с
бадчеҳра	с
бадя	о
бадқовоқ	с
бадҳаво	с
бадҳазм	с
бадҳайбат	с
баёв	с
баёз	о
баён	о
баённома	о
баёнот	о
баёнчилик	о
баёт	о
бажармоқ	ф
бажо	р
бажонидил	р
база	о
базавий	с
базальт	о
баззоз	о
баззозлик	о
базис	о
базл	о
базм	о
базмаро	о
базмгоҳ	о
базморо	с
базмхона	о
базмчи	о
базўр	р
бай	о
бай-бай	у
байбайламоқ	ф
байдарка	о
байдоқ	о
байзо	с
байир	о,с
байирлашмоқ	ф
байлашмоқ	ф
байналмилал	с,о
байналмилаллик	с
байналмилалчи	о
байналмилалчилик	о
байналмиллий	с
байналхалқ	с
байрам	о
байрамбозлик	о
байрамлашмоқ	ф
байрамлик	о
байрамолди	с
байрамона	с
байроқ	о
байроқдор	о
байроқли	с
байроқча	о
байт	о
байтал	о
байталмон	с
байтар	о
байтария	о
байтулаҳзон	о
байтулло	о
байтуллоҳ	о
байтулмол	о
байтқўрғони	о
байтқўрғоний	о
байт-ғазал	о
бак	о
бака-банг	т
бакалавр	о
бакалавриат	о
баковул	о
баковулбоши	о
бакор	ф
бакорат	о
бакра	о
бакрабалиқ	о
бактериал	с
бактериолог	о
бактериологик	с
бактериология	о
бактерицид	с
бактерия	о
бал	о
балабон	о
баладия	о
балалайка	о
баланд	с
баландламоқ	ф
баландлатмоқ	ф
баландлик	о
баландпарвоз	с
баландпарвозлик	о
баланд-паст	с
баланд-пастлик	о
баланс	о
балансир	о
балансировка	о
балансламоқ	ф
балансомер	о
балбала	о
балдоқ	о
бале	ю
балерина	о
балет	о
балетмейстер	о
балетчи	о
бали	ю
балиқ	о
балиғ	о
балиқкўз	о
балиқпаз	о
балиқтозалагич	о
балиқтут	о
балиқфуруш	о
балиқчи	о
балиқчилик	о
балиқчи-укки	о
балиққийғир	о
балка	о
балкар	о,с
балкалар	о
балки	б
балким	б
балкон	о
балл	о
баллада	о
балласт	о
балластер	о
балли	ю,с
баллистик	с
баллистика	о
баллон	о
баллонли	с
бало	о
бало-баттар	о
балогардон	с
балодай	р
балокаш	с
бало-офат	о
балон	с
балохўр	о
бало-қазо	о
балоқ	о
балоғат	о
балх	о
балхи	о
балчиқ	о
балчиқли	с
балчиқлик	о
балчиқчи	о
балчиқчилар	о
бальзам	о
бальзамлаш	ф
бальнеолог	о
бальнеологик	с
бальнеология	о
бальнеотерапия	о
бальнеотехника	о
балқ	т
балқимоқ	ф
балқитмоқ	ф
балғам	о
балғами	с
бамаза	с
бамайлихотир	р
бамайлихотирлик	о
бамаслаҳат	р
бамаъни	с
бамахнилик	о
бамбук	о
бамбукайиқ	о
бамбукзор	о
бамисли	к
бамисоли	к
банан	о
бананзор	о
бананхўр	о
бананхўрлар	о
банг	о
банги	о
бангидевона	о
бангибашара	с
бангилик	о
бангинамо	с
бангинусха	с
бангихона	о
банд	о,с
банда	о
бандаж	о
бандак	о
бандалик	о
бандар	о
бандагоҳ	о
бандахона	о
бандачилик	о
бандероль	о
банди	о
бандибаст	о
бандибон	о
бандизиндон	о
бандилик	о
бандисифат	р
бандит	о
бандитизм	о
бандитлик	о
бандихона	о
бандли	с
бандлик	о,с
банибашар	о
баниинсон	о
баниодам	о
банк	о
банка	о
банкаброш	о
банкет	о
банкир	о
банкнот	о
банкомат	о
банкрот	о
банкротлашмоқ	ф
банкротлик	о
баногоҳ	о
банорас	о,с
банот	о
бант	о
бантик	о
бантулар	о
баобрў	с
баптизм	о
баптист	о
бапуржа	р
бар	о
барабан	о
барабанчи	о
баравар	с,р,к
бараварига	к
бараварида	к
бараварламоқ	ф
бараварлашмоқ	ф
бараварлик	о
баравж	с
барак	о
барака	о
баракали	с
баракалла	у
баракаллачи	о
баракасиз	с
баракат	о
баракатли	с
баракатсиз	с
барала	р
баралла	р
баранғор	о
бараҳман	о
бараҳна	с
барбод	о
барваста	с
барвасталик	о
барвақт	р
барг	о
баргак	о
баргизуб	о
баргизўт	о
баргикарам	с
баргламоқ	ф
баргли	с
баргрезон	о
барда	о
бардавом	с
бардам	с
бардамлашмоқ	ф
бардамлик	о
бардаст	о
барди	о
бардор	о
бардор-бардор	ф
бардош	о
бардошли	с
бардошлилик	о
бардошсиз	с
барельеф	о
баржа	о
барзанги	о
барзангисифат	с
бари	о
барибоғ	о
баривож	с
барий	о
барикарам	с
баримта	о
барин	о
барина	о
барисфера	о
барит	о
баритон	о
баркамол	с
баркамоллик	о
баркаш	о
барлос	о
бармен	о
бармоқ	о
барно	о
баро-	с
баробар	с
барограмма	о
барограф	о
барокамера	о
барокко	о
барол	о
барометр	о
барометрик	с
барон	о
барор	о
барот	о
баротерапия	о
баротравма	о
бароқ	с
бароққош	с
барпо	с
барра	о
баррель	о
баррикада	о
барс	о
бартараф	о
бартер	о
бархан	о
барханлар	о
бархит	о,с
барча	ол
барш	о
баршчина	о
барьер	о
барқ	о
барқарор	с
барқарорлик	о
барқут	с
барҳаво	с
барҳаёт	с
барҳам	c
барҳақ	c
бас	у,о
басавлат	с	
басалобат	с
басир	с
басират	о
басит	с
баскетбол	о
баскетболчи	о
баски	у
баслашмоқ	ф
басма-бас	о
басма-басга	р
басма-басига	р
басмабаслашмоқ	ф
басмабасликка	р
бассейн	о
баст	о
баста	ф
бастакор	о
бастакорлик	о
басталамоқ	ф
басталик	о
бастион	о
батальон	о
батамиз	с
батамом	р
батанг	с
батарея	о
батар	р
батарин	с
батартиб	с,р
батафсил	р
батискаф	о
батист	о
батисфера	о
батометр	о
батон	о
батрак	о
батраклашмоқ	ф
баттар	р
баттарин	р
баттарлашмоқ	ф
баттол	с
баттоллик	о
бафармон	о
бафуржа	р
бахабар	с
бахаёл	р
бахаёлга	р
бахайр	с
бахил	с
бахиллик	о
бахмал	о,с
бахмалпўш	с
бахт	о
бахташ	о
бахтиёр	с
бахтиёри	о
бахтиёрий	о
бахтиёрийлар	о
бахтиёрлик	о
бахт-иқбол	о
бахтиқаро	с
бахтли	с
бахтнома	о
бахт-саодат	о
бахтсиз	с
бахтсизлик	о
бахш	ф
бахшанда	о
бахши	о
бахшида	ф
бахшиш	о
бахя	о
бахядўз	о
бахяламоқ	ф
бациллар	о
бача	о
бачча	о
бачадон	о
бачажиш	о
бачалик	о
бачкана	с
бачканабоз	о
бачканабозлик	о
бачканагарчилик	о
бачканадўз	о
бачканаларча	р
бачканалашмоқ	ф
бачканалаштирмоқ	ф
бачканалик	о
бачки	о
бачкиламоқ	ф
бачча	о
баччабоз	о
баччабозлик	о
баччалик	о
баччаталоқ	о
баччахўрак	о
баччағар	о
башанг	с
башар	о
башара	о
башарий	с
башарият	о
башарти	б
башня	о
башорат	о
башоратли	с
башоратчи	о
баъд	р
баъда	р
баъдаз	р
баъзан	р,б
баъзи	ол
баъзида	р
баякбор	р
баян	о
баянчи	о
бақа	о
бақавли	м
бақадриҳол	р
бақай	о
бақажўхори	о
бақалоқ	о,с
бақам	р
бақамти	р
бақанг	о
бақар	о
бақара	о
бақасалла	о
бақатерак	о
бақатўн	о
бақачаноқ	о
бақаяпроқ	о
бақақуруллоқ	о
бақбақа	о
бақбақали	с
бақ-бақалоқ	с
бақилламоқ	ф
бақир	о
бақир-буқур	т
бақиришмоқ	ф
бақириқ	о
бақириқ-чақириқ	о
бақирламоқ	ф
бақирмоқ	ф
бақироқ	с
бақир-чақир	о
бақия	о
бақиядор	о
бақлажон	о
бақо	о
бақосиз	с
бақрайганча	р
бақраймоқ	ф
бақрайтирмоқ	ф
бақрайтмоқ	ф
бақувват	с
бақувватлик	о
баққа	о
баққол	о
баққоллик	о
баққолхона	о
баққолчилик	о
бағаз	о
бағайрат	с
бағбақа	о
бағбақадор	с
бағ-буғ	т
бағдаш	о
бағдоди	о
бағдодий	с
бағиз	о
бағилламоқ	ф
бағир	о
бағир-буғур	т
бағирлаб	к
бағирламоқ	ф
бағишламоқ	ф
бағишловчи	о
бағоят	р
бағрикенглик	о
бағритош	с
бағриқора	о
бағриқурт	о
баҳаво	с
баҳаё	с
баҳай	с
баҳайбат	с
баҳам	ф
баҳамжиҳат	р
баҳамжиҳатлик	о
баҳарнав	р
баҳарҳол	р
баҳақ	р
баҳаққ	р
баҳ-баҳ	у
баҳбаҳламоқ	ф
баҳиммат	с
баҳо	о
баҳодир	с,о
баҳодирлар	о
баҳодирлик	о
баҳодирларча	р
баҳодирона	р
баҳоий	о
баҳоийлик	о
баҳоламоқ	ф
баҳолашмоқ	ф
баҳоли	с
баҳоловчи	о
баҳона	о
баҳоначи	о
баҳор	о
баҳорги	с
баҳори	с
баҳорий	с
баҳорикор	с
баҳорикорлик	о
баҳористон	о
баҳосиз	с
баҳр	о
баҳра	о
баҳраланмоқ	ф
баҳраманд	о
баҳрасиз	с
баҳрибайт	о
баҳридил	о
баҳрин	о
баҳс	о
баҳсдош	о
баҳслашмоқ	ф
баҳслашув	о
баҳслашувчи	о
баҳс-мунозара	о
баҳсталаб	с
баҳсчи	о
баҳузур	р
бе	у
бе-
беадаб	с	
беадабгарчилик	о
беадаблик	о
беадабона	р
беадабчилик	о,с
беадад	с
беаёв	р
беаёвлик	о
беажал	с
беажин	с
беазият	р
беазоб	с
беайб	с
беамал	с
беамр	р
беандаза	р,с
беандиша	с
беандишалик	о
беандуҳ	р
беараз	р
беармон	р
беасо	р
беасорат	р
беахлоқ	с
беахлоқлик	о
беақл	с
бебадал	с
бебарака	с
бебаркаш	с
бебарор	р
бебахт	с
бебақо	с
бебаҳо	с
бебаҳра	с
бебилиска	с
бебилчак	о
бебозор	с
бебок	 с
бебош	с
бебошбоғ	с
бебошвоқ	с
бебошлик	о
бебурд	с
бебурдлик	о
бева	с
бева-бечора	о
беваж	р
беваҳ	р
бевалик	о
бевасиқа	 с
беватан	с
бевафо	с
бевафолик	о
бевақт	р
бевосита	р
бевош	с
бевошлик	о
бегемот	о
бегим	о
бегимсуйди	о
бегойим	о
бегона	о
бегоналашмоқ	ф
бегоналик	о
бегонасирамоқ	ф
бегор	о
бегумон	р
бегуноҳ	с
беда	о
бедав	с
бедавлат	с
бедавлатлик	о
бедаво	с
бедазор	о
бедакор	о
бедакорлик	о
бедана	о
беданабоз	о
беданамашак	о
бедапоя	о
бедарак	р
бедарвоза	с
бедард	с
бедармон	с
бедармонлик	о
бедахмаза	р
бедахона	о
бедачилик	о
бедил	с,о
бедилона	с
бедилхонлик	о
бедин	с
бедов	с
бедод	о
бедодлик	о
бедом-дарак	р
бедона	с
бедор	с
бедорлик	о
бедоғ	с
бежама	о,с
бежамадор	с
бежамоқ	ф
бежанжал	с
бежиз	р
бежирим	с
бежо	р
бежой	с
бежоланмоқ	ф
бежон	с
бежоғлиқ	с
без	о
безабон	с,о
безавол	с
безак	о
безакдор	с
безакли	с
безакот	с
безаксиз	с
безакчи	о
безамоқ	ф
безангламоқ	ф
безанжир	с
безанмоқ	ф
безарар	с
безаха	с
без-без	т
безбет	с
безбетлик	о
безгак	о
безгакдори	о
безгакнамо	c
безгакпашша	о
безгалдак	о
бездирмоқ	ф
безиён	с
безилламоқ	ф
безмоқ	ф
безовта	с
безовталанмоқ	ф
безовталик	о
безовчи	о
безор	о
безори	о
безорижон	о
безорилик	о
безот	с
безраймоқ	ф
безурриёт	с
беибо	с
беидрок	с
беижозат	р
беиз	с,р
беизн	р
бизтироб	р
беиллат	с
беимон	с
беинсоф	с
беинтиҳо	с
беистисно	р
беихтиёр	р
беиш	р
беишкал	р
беиштаҳа	р
беиштиёқ	р
беишқ	с
беиқбол	р
бек	о
бека	с
бекам-кўст	р
беканор	с
бекарам	с
бекас	с
бекас-бенаво	с
бекаслик	о
бекат	о
бекатча	о
бекатчи	о
бекафан	с
бекач	о
бекбачча	о
беквачча	о
бекенгаш	с
бекзод	о
бекзода	о
бекзоди	о
бекзот	о
бекик	с
бекилмоқ	ф
бекимса	с
бекинмачоқ	о
бекинмоқ	ф
бекитиқча	р
бекитмоқ	ф
бекламоқ	ф
бекларбеги	о
беклик	о
бекойиш	р
бекор	р
бекорга	р
бекордан-бекор	р
бекордан-бекоргар	р
бекорлик	о
бекорчи	о,с
бекорчилик	о
бекорчихўжа	о
бекуч	с
бел	о
белаззат	с
белак	о
беламоқ	ф
беланг	с
беланги	с
беланмоқ	ф
беланчак	о
беланчаксимон	с
беланғич	с
белат	о
белатчи	о
белашмоқ	ф
белбоғ	о
белбоғли	с
белбоғлик	с
белбурма	с
белги	о
белгиламоқ	ф
белгиланмоқ	ф
белгилаш	ф
белгили	с
белгиловчи	о
белгисиз	с
белдамча	о
белдов	с
белдор	с,о
белила	о
белкаш	о
белкурак	о
белладонна	о
беллашмоқ	ф
беллашув	ф
беллетрист	о
беллетристик	с
беллетристика	о
белли	с
беллик	о
белма-бел	р
белорус	о
белоруслар	о
белорусча	с
белуга	о
белуж	о
белуха	о
белча	о
белчаламоқ	ф
белчи	о
бельведер	о
бельгиялик	о
бельтинг	о
бельэтаж	о
белўроқ	о
бемаврид	р
бемадор	р
бемадорлик	о
бемажол	с,р
бемажоллик	о	
бемаза	с
бемазагарлик	о
бемазагарчилик	о
бемазалашмоқ	ф
бемазалик	о
бемазачилик	о
бемакон	с
бемалол	р
бемаслак	р
бемаслаҳат	р
бемашаққат	с,р
бемашварат	р
бемаъни	с,р
бемаънигарчилик	о
бемаънилик	о
бемаъно	с,р
бемаърифат	о
бемақсад	с,р
бемаҳал	о,р
бемерос	р
бемеъёр	с
бемеҳр	с
бемеҳрлик	о
беминнат	р
бемисл	с
бемисол	c
бемиқёс	c
бемор	о
беморлик	о
беморона	с
беморхона	о
бемуддат	с
бемулоҳазалик	о
бемурод	р
бемурувват	с
бенавбат	р
бенаво	с
бенажот	с
беназир	с,о
бенамоз	с
бенарвон	р
бенасаб	c
бенасиб	р
бенаф	р
бенгал	о
бенгаллар	о
бенгзамоқ	ф
бенефис	о
бензин	о
бензобак	о
бензовоз	о
бензоколонка	о
бензол	о
бенишон	с
бениҳоя	с,р
бениҳоят	с,р
беном	с
беном-нишон	р
беномус	с
беномуслик	о
бентонитлар	о
бентос	о
бенур	с
бенуқсон	с
бенўхта	с
беобрў	с
беобрўй	с
беодоб	с
беодоблик	о
беозор	с,р
беозорлик	о	
беомон	р
беор	с
беорлик	о
беором	с,р
беоқибат	с	
беоқибатлик	о
бепадар	с
бепайров	р
бепанд	с
бепарво	c,р
бепарволик	о
бепарда	с,р
бепардоз	с,р
бепаровуз	с
бепарҳез	с
беписанд	р
беписандлик	о
бепичоқ	с
бепоён	с
бепоёнлик	о
бепосанги	с
бепошна	с
бепул	с
бепул-бебадал	р
бепушт	с
бепуштлик	о
берармон	о
бераси	о
берағон	с
бераҳм	с
бераҳмлик	о
берберчи	о
берданка	о
берет	о
беретка	о
бери	р,к
берига	к
бериги	с
берида	к
бериё	р
берилган	ф
берилганлик	о
берилл	о
бериллий	о
берилмоқ	ф
берилувчан	с
берилувчанлик	о
беришмоқ	ф
берк	с
бермоқ	ф
бертолле	о
бертоллидлар	о
берухсат	р
беруҳ	с
берч	с
бесабаб	р
бесабр	с
бесабрлик	о
бесавод	с
бесамар	с,р
бесамара	р
бесаноқ	с
бесар	с
бесаранжом	с
бесаранжомлик	о
бесаришта	с
бесас	р
бесоат	с
бесоқол	с
бесоқолбоз	с
бесоҳиб	с
бессемер	о
бессемерлаш	ф
бесубут	с
бесўнақай	с
бесўров	р
бет	о
бета	о
бетавфиқ	с
бетайин	с
бетакаллуф	c
бетакрор	c
бетамиз	c
бетамизлик	о
бетараф	с
бетарафлик	о
бетарафона	р
бетартиб	с
бетаскин	с
беташвиш	с
бетаълим	с
бетаъриф	с,р
бетаъсир	с
бетаҳлика	с
бетаҳорат	р
бетгачопар	с
бетгачопарлик	о
бетергов	р
бетизгин	с
бетийиқ	c
бетилсим	c
бетимсол	c
бетиним	c
бетинч	c
беткай	о
бетламоқ	ф
бетлаштирмоқ	ф
бетма-бет	р
бетоб	с
бетоблик	о
бетоле	с
бетон	о
бетонламоқ	ф
бетончи	о
бетонқоргич	о
бетоқат	с
бетоқатланмоқ	ф
бетоқатлик	о
бетсиз	с
бетутуриқ	с
бетўхтов	с,р
беун	р
беунум	с
беустухон	с
бефайз	с
бефарзанд	с
бефарзандлик	о
бефармон	р
бефаросат	с
бефаросатлик	о
бефарқ	с,р
бефарқлик	о
бефаҳм	с
бефаҳмлик	о
бефириб	с,р
бефойда	с
бехабар	р,с
бехавотир	с	
бехавотирлик	о
бехавф	р,с
бехалал	р
бехархаша	р
бехатар	с
бехато	с,р
бехирад	с
бехислат	р
бехор	с
бехос	р
бехосдан	р
бехосият	с
бехуд	с
бехудлик	о
бечиз	р
бечиқим	р
бечиқит	р
бечора	с
бечоралик	о
бечорапарвар	о
бечорачилик	о
бечораҳол	с
беш	сн,с
бешак	р
бешамак	о
бешарм	с
бешармлик	о
бешафқат	с
бешбарг	о
бешбармоқ	о
бешбаттар	р
бешбел	о
бешик	о
бешикаст	р
бешик-белик	о
бешиккертти	о
бешиксўпоқ	с
бешиктерватар	о
бешинчи	сн
бешкашта	о
бешкокил	с
бешкураш	о
бешкўтарар	о
бешлик	о
бешмат	о
бешов	ол
бешовлон	ол
бешотар	с
бешта	сн
бешуруғ	о
бешуур	с
бешқарсак	о
бешқарта	о
беэга	с
беэътибор	с,р
беэътиқод	с
беюз	с
беюзлик	о
беўлчов	с
беўрин	с,р
беўхшов	с
беқадр	с
беқарор	с
беқарорлик	о
беқасам	с
беқиёс	с
беқувват	с
беқувватлик	о
беғалва	с
беғам	с
беғамлик	о
беғараз	с,р
беғаразлик	о
беғаразона	р
беғубор	с
беғуборлик	о
беҳ	с
беҳад	с,р
беҳадлик	р
беҳаё	с
беҳаёлик	о
беҳаловат	с
беҳафсала	с,р
беҳафсалалик	о
беҳашам	с
беҳ-беҳ	у
беҳбеҳламоқ	ф
беҳбуд	с
беҳбудлик	о
беҳи	о
беҳигул	о
беҳизор	о
беҳикмат	с
беҳис	с
беҳисоб	с
беҳишт	о
беҳишти	о
беҳол	с,р
беҳоллик	о
беҳтар	о,с
беҳуда	р
беҳудага	р
беҳудалик	о
беҳудуд	с
беҳудудлик	о
беҳузур	с
беҳунар	с
беҳурмат	с
беҳурматлик	о
беҳуш	с,р
би-	сн
биатлон	о
биббинойи	р
биби	о
бибиш	о
бибишак	о
библиограф	о
библиографик	с
библиография	о
библиотека	о
библия	о
бигиз	о
бигизламоқ	ф
бигизпошна	о
бигизтумшуқ	о
бидилламоқ	ф
бидир-бидир	т
бидирламоқ	ф
бидон	о
бидъат	о
бидъаткор	о
бидъатчи	о
биё-биё	т
биёбон	о
биёв-биёв	т
биж-биж	т
бижанак	о
бижилдоқ	с
бижилдоқлик	о
бижилламоқ	ф
бижимоқ	ф
бижир-бижир	т
бижирламоқ	ф
бижғимоқ	ф
биз ол
биз-биз	т
бизбизак	о
бизбоп	с
бизилдоқ	о
бизилламоқ	ф
бизнес	о
бизнесмен	о
бизнесчи	о
бизники	ол
бизоат	о
бизон	о
бизғалдоқ	о
бий	о
бийбува	о
бийдай	с,р
бийи	о
бийламоқ	ф
бийлатмоқ	ф
бийлик	о
бийрон	с
бийрон-бийрон	р
бийронлашмоқ	ф
бийронлик	о
бийча	о
бика	о
бикамерализм	о
бикарбонатлар	о
бикач	о
биквадрат	с
бикир	с
бикр	с
била	к
билагузук	о
билак	о
билакс	р
билакма-билак	р
билакузук	о
билан	к,б
биланг-биланг	т
билангламоқ	ф
билар-билмас	р
билармон	с
билармонлик	о
билағон	с
билағонларча	р
билағонлик	о
билвосита	р
билганича	р
билгиларича	р
билгир	с
билгич	с
билгича	р
билдиргич	о
билдириш	ф
билдиришнома	о
билдирмоқ	ф
билет	о
билетчи	о
билжинг-билжинг	т
билжирамоқ	ф
билжирамоқ	ф
билик	о
билим	о
билимдон	с
билимдонлик	о
билимдор	с
билимли	с
билимсиз	с
билимсизлик	о
билинар-билинмас	с,р
билинарли	с,р
билингвизм	о
билиниб-билинмай	р
билинмоқ	ф
билинтирмоқ	ф
билиттифоқ	р
билиш	ф
билишимча	р
билкут	о
билла	р
биллиард	о
биллиардхона	о
билло	м
биллоҳ	м
биллур	о
биллурий	c
биллурин	c
биллурсимон	c,р
билмак	ф
билмам	м
билмаслик	о
билмол	о
билмоқ	ф
билмоқлик	о
билониҳоя	с
билтангламоқ	ф
билфъел	р
билч-билч	т
билчилламоқ	ф
билъакс	р
бильярд	о
билқ-билқ	т,с,р
билқилдоқ	с
билқиллама	с
билқилламоқ	ф
биметалл	о,с
биметаллар	с
биметаллизм	о
бин	о
бинар	с
бинафша	о,с
бинафшагул	о
бинафшазор	о
бино	о
биноан	к
бинобарин	б
бинойи	с,р
бинойидай	с,р
бинокль	о
бинокор	о
бинокорлик	о
бином	о
бинт	о
бинтламоқ	ф
био-	с
биоакустика	о
биобиблиография	о
биогенез	о
биогеография	о
биографик	с
биография	о
биоиндикаторлар	о
биоиқлимшунослик	о
биокимё	о
биокимёвий	с
биоклиматология	о
биолаборатория	о
биолог	о
биологик	с
биология	о
биолокация	о
биолюминесценция	о
биомайдон	о
бионика	о
биооптика	о
биополимер	о
биополимерлар	о
биосинтез	о
биосфера	о
биотелеметрия	о
биотехнология	о
биотип	о
биофизик	о,с
биофизика	о
биохимик	о,с
биохимия	о
биоқувват	о
биофильтр	о
бипартид	о
биплан	о
бир	сн,ол
биракай	с,р
биракайига	р
бирам	с,р
биратўла	р
биратўласи	с
бир-бир	р
бир-бири	р
бир-бировига	р
бир-бировидан	р
бир-бировини	р
бирваракай	р
бирваракайига	р
бирваракасига	р
бирга	р
биргалашмоқ	ф
биргалик	о
биргаликда	р
биргина	ю
бирда	р
бирдай	с,р
бирдам	с
бирдамлик	о
бирдан	р
бирдан-бир	с
бирданига	р
бирён	с
бирёқламалик	о
биржа	о
биржачи	о
бирикиш	ф
бирикма	о
бирикмоқ	ф
бириктирмоқ	ф
бириктирувчи	о
бирин-бирин	р
биринж	о
бирин-кетин	р
бирин-сирин	р
биринч	о
биринчи	сн
биринчидан	сн
биринчилик	о  
бириси	ол
бирич	о
бирйўла	р
бирка	о
биркитилмоқ	ф
биркитмоқ	ф
бирла	б
бирламчи	c 
бирлан	к
бирлашган	ф
бирлашма	о
бирлашмоқ	ф
бирлаштирмоқ	ф
бирлик	о
бирликда	р
бирма-бир	р
бирмунча	р
бирнеча	ол
бирнима	ол
биров	сн,ол
биродар	о
биродарзода	о
биродаркушлик	о
биродарларча	р
биродарлашмоқ	ф
биродарлик	о
биродарона	р
бироз	р
бирон	ол
биронта	ол
бирон-бир	ол
биронғор	о
бирор	ол
бирорта	ол
биротар	о
бироқ	б
бирпас	р
бирпасда	р
бирпаслик	с
биррав	р
бирсўзли	с
биртагина	сн
бирталай	ол
биру бор	о
бирхил	ол
бирхиллаштириш	ф
бирқадар	ол
бирқанча	ол
бирқатор	ол
бирқозон	о
бирқулоқ	о
бирқур	р
бирҳад	о
бисёр	р
бисквит	о
бисмилло	м
бисмиллоҳ	м
бисот	о
бисот-бағал	о
бисотли	с
биссектриса	о
бистар	о
бит	о
битбилдиқ	т
битбозлик	о
битик	о
битиклик	о
битикчи	о
битилмоқ	ф
битим	о
битирмоқ	ф
битирувчи	о
битишмоқ	ф
битишув	ф
биткўз	о
битламоқ	ф
битлиқи	с
битма	с
битмас	ф
битмас-туганмас	с
битмоқ	ф
битов	о
битта	сн
битта-битта	р
битта-биттадан	сн
биттагина	сн
биттадан	сн
битта-иккита	сн
битталаб	р
биттанга	о
битта-яримта	ол
битумлар	о
бифидобактериялар	о
бифштекс	о
бих	о
бичиб-тўқимоқ	ф
бичилиш	о
бичилмоқ	ф
бичим	о
бичимли	с
бичимсиз	с
бичиш-тикиш	о
бичиқ	о
бичиқлик	с
бичиқчи	о
бичиқчилик	о
бичмоқ	ф
бичувчи	о
биюрғун	о
бия	о
биқ-биқ	т
биқилламоқ	ф
биқин	о
биқинида	к
биқинмоқ	ф
биқир-биқир	т
биқирламоқ	ф
биқиқ	с
биқиқлик	о
биқмоқ	ф
биқсимоқ	ф
биқтирма	с
биққа	с
биққадай	ф
биққи	с
биғ-биғ	т
биғилламоқ	ф
биҳишт	о
биҳишти	о
бланк	о
блефарит	о
блиндаж	о
блок	о
блокада	о
блокнот	о
блуза	о
блузка	о
блуминг	о
бо	м,у
бо-	c
боа	о
боадаб	с
боб	о
бобаракот	с
бобий	о
бобийлик	о
бобилламоқ	ф
бобина	о
бобма-боб	р
бобо	о
бобов	о
бободеҳқон	о
бобой	о
бобойи	о
бобокалон	о
бобокент	о
бобомерос	о
боботил	о
боботоғ	о
бобочўпон	о
бобочинор	о
бобр	о
бобрик	о
бобуна	о
бобслей	о
бобурийлар	о
бобуршунослик	о
бов	о
бова	о
бовар	о
бовлиқ	о
бовужуд	р
бовур	о
бовурдошлик	о
бовурчи	о
бод	о
бода	о
бодапараст	о
бодафуруш	о
бодахўр	о
бодбезак	о
боди	с
бодибилдинг	о
бодиён	о
бодиланмоқ	ф
бодилик	о
бодия	о
бодом	о
бодомзор	о
бодомий	о
бодомсимон	с
бодомой	о
бодомча	о
бодомқовоқ	о
бодпаррак	о
бодпо	с
бодпой	с
бодрамоқ	ф
бодрезак	о
бодринг	о
бодроқ	о
бодроқчи	о
бодроққанд	о
бод-ҳаво	о
боёв	с
боёвут	о
боёк	о
боён	о
боёна	с
боёқиш	с
бож	о
божа	о
божачилик	о
божгир	о
бождор	о
божмон	о
божраймоқ	ф
бож-хирож	о
божхона	о
боз	о
бозбанд	о
бозбарак	о
бозгўй	о
бози	о
бозигар	о
бозилламоқ	ф
бозингар	о
бозиргон	о
бозор	о
бозорбон	о
бозорбоп	с
бозорбоши	о
бозоргир	с
бозоргон	о
бозори	с
бозорком	о
бозорламоқ	ф
бозорлашмоқ	ф
бозорлик	о
бозорчи	о
бозорчилик	о
бозоршаб	о
бозор-ўчар	о
бозубанд	о
бозургоний	о
боис	о
бой	с
бойбачча	о
бойбичча	о
бой-боёнлар	о
бойбува	о
бой-бўй	у
бойвачча	о
бойваччалик	о
бойвучча	о
бойдоқ	о
бойёнғоқ	о
бойзода	о
бойимоқ	ф
бойитмоқ	ф
бойитилмоқ	ф
бойкен	о
бойкот	о
бойлам	о
бойламоқ	ф
бойланмоқ	ф
бойлашмоқ	ф
бойлик	о
бойлов	о
бойпараст	о
бойтеват	о
бойтузоқ	о
бойхалча	о
бойча	о
бойчечак	о
бойўғли	о
бойқизи	о
бойқуш	о
бойқушхона	о
бойғоза	о
бок	о
бокал	о
бокир	с
бокира	с
бокс	о
боксёр	о
боксёрлик	о
боксит	о
боксча	р
боксчи	о
бол	о
бола	о
болажратгич	о
бола-бақра	о
болабоп	с
болажон	о
болажонлик	о
болакай	о
болаламоқ	ф
болаларбоп	с
болаларча	р
болалатмоқ	ф
болали	с
болалик	о
болали-чақали	с
болапарвар	с
болапарварлик	о
болапақир	с
болари	о
боласиз	о
боласизлик	о
болатой	о
болача	о
бола-чақа	о
бола-чақали	с
болболлар	о
болгар	о
болгари	о
болгарча	с,о
болдиз	о
болдир	о
болдирқора	о
болдирғон	о
болдоқ	о
болид	о
болиш	о
болиғ	с
болиға	о
болиғлик	о
боло	с
болометр	о
болон	с
болонишин	о
болонья	о
болопўш	о
болор	о
болорли	с
болохона	о
болохонадор	с
болохонали	с
болоқ	о
болт	о
болта	о
болталамоқ	ф
болтатумшуқ	о
болтачи	о
болтаютар	о
болтириқ	о
болтли	с
бол-пар	о
болут	о
болутзор	о
большевизм	о
большевик	о
болқимоқ	ф
болқин	о
болқон	о
болқор	о,с
болқорлар	о
болқурай	о
болға	о
болғабалиқ	о
болғабош	о
болғаламоқ	ф
болғали	о
болғача	о
бомаза	с
бомаслаҳат	р
бомба	о
бомбапана	о
бомбардимон	о
бомбардимончи	о
бомбаотгич	о
бомбомёт	о
бомдод	о
бонг	о
бону	о
бонус	о
бообрў	с
боодоб	с
боп	с
боплаб	ф
бопламоқ	ф
бопта	с
бор	с,о
бора	сн
бора-бора	р
боракалло	м
борасида	к
бор-буд	о
боргоҳ	о
борди-келди	о
борди-ю	б
бордон	о
бордондай	с
бордончи	о
боржом	о
боржоми	о
бори	ол
бориб-бориб	р
бори-йўғи	ол
борингки	м
борича	р
бориш-келиш	о
боришли-келишли	о
бор-йўғи	о
борламоқ	ф
борлик	о
борлиқ	о
бормоқ	ф
борона	о
бороналамоқ	ф
борт	о
бортмеханик	о
бортпроводник	о
боршч	о
боса-боса	р
босабот	c
босар-тусар	о
босафо	с
босволди	о
босди-босди	о
босиб-босиб	р
босилдириқ	о
босилмоқ	ф
босим	о,р
босимли	с
босинқи	с
босинқилик	о
босинқирамоқ	ф
босириқ	о
босириқмоқ	ф
босирқамоқ	ф
босишмоқ	ф
босиқ	с
босиқлик	о
босиғлиқ	с
босма	о
босмахона	о
босмачи	о
босмачилик	о
босмоқ	ф
бости-бости	о
бостирилмоқ	ф
бостириқ	о
бостирма	о
бостирманамо	с
бостирмоқ	ф
бостон	о
босқи	о
босқин	о
босқинчи	о
босқинчилик	о
босқич	о
босқичли	с
босқичма-босқич	с
босқон	о
босқончи	о
босқоқ	о
бот	р
ботаник	о,с
ботаника	о
ботартиб	с
бот-бот	р
ботил	с
ботин	о
ботинан	р
ботиний	с
ботинка	о
ботинмоқ	ф
ботинқи	с
ботир	с
ботирилмоқ	ф
ботирланмоқ	ф	
ботирларча	р
ботирлашмоқ	ф
ботирлик	о
ботирмоқ	ф
ботиқ	с
ботма-бот	р
ботмон	о
ботмон-ботмон	сн
ботмон-даҳсар	о
ботмонламоқ	ф
ботмонлик	о
ботмоқ	ф
ботулизм	о	
ботқалдоқлар	о
ботқоқ	о,с
ботқоқзор	о
ботқоқланмоқ	ф
ботқоқли	с
ботқоқлик	о
боумид	с
бофанда	о
бохабар	с
боцман	о
бочка	о
бочкасимон	с
бош	о,с,сн
бошариқ	о
бошафқат	с
бошбошдоқ	с
бошбошдоқлик	о
бошвоқ	о
бошвоқсиз	с
бошвоқсизлик	о
бошбармоқ	о
бошда	р
бошдан	р
бошдан-оёқ	р
бошига	к
бошида	к
бошидан	к
бошижоат	с
бошкесарлар	о
бошлаб	ф
бошлама	о
бошламоқ	ф
бошланма	ф
бошланғич	о
бошлашмоқ	ф
бошли	с
бошлиқ	о
бошловчи	о
бошма-бош	р
бошмалдоқ	о
бошмоқ	о
бош-оёқ	с,р
бошоқ	о
бошоқламоқ	ф
бошоқли	с
бошоқчи	о
бошоғриқ	о
бошпана	о
бошпанасиз	с
бошпурт	о
бошсиз	с
бошчи	о
бошчилик	о
бошяланг	с
бошқа	с
бошқа-бошқа	с
бошқаламоқ	ф
бошқалик	о
бошқарилмоқ	ф
бошқариш	ф
бошқарма	о
бошқармоқ	ф
бошқарув	ф
бошқарувчи	о
бошқатдан	р
бошқача	с,р
бошқачалик	о
бошқирд	о
бошқирдлар	о
бошқирдча	с,о
бошқоронғи	с
бошқоронғилик	о
бош-қош	о
бошқурт	о
боя	р
бояги	ол
боягидай	р
боягидек	р
боягича	р
боякбор	р
боялич	о
бояр	о
боярлар	о
бояқиш	о
боқи	с
боқибеғам	с
боқибеғамлик	о
боқизмоқ	ф
боқи	с
боқий	с
боқийлик	о
боқим	о
боқимонда	о
боқимондалик	о
боқимсиз	с
боқинди	о
боқиш	ф
боқишмоқ	ф
боқия	о
боқла	о
боқмоқ	ф
боқон	о
боқув	ф
боқувли	с
боқувчи	о
боқча	о
боғ	о
боғбон	о
боғбонлик	о
боғбончилик	о
боғ-бўстон	о
боғу бўстон	о
боғдор	о
боғдорлик	о
боғдорчилик	о
боғистон	о
боғич	о
боғичли	с
боғичсиз	с
боғлам	о
боғлама	о
боғламоқ	ф
боғланиш	о
боғланмоқ	ф
боғлашмоқ	ф
боғлағич	о
боғли	с
боғлиқ	ф
боғлиқлик	о
боғлов	о
боғловчи	ф
боғловчисиз	р
боғлоғлик	с
боғма-боғ	р
боғот	о
боғ-роғ	о
боғча	о
боғчачилик	о
боғчилик	о
брадикардия	о
брак	о
браковка	о
браконьерлик	о
бракчи	о
брандспойт	о
браслет	о
брасс	о
браунинг	о
браҳман	о
браҳманизм	о
браҳманзода	о
брезент	о,с
бригада	о
бригададош	о
бригадир	о
бригадирлик	о
бриз	о
брикет	о
брикетламоқ	ф
бриллиант	о
бринза	о
бриолог	о
бриология	о
бритт	о
брифинг	о
бричка	о
бройлер	о
брокер	о
бром	о
бронеавтомобиль	о
броневик	о
бронемашина	о
броненосец	о
бронепоезд	о
бронетранспортёр	о
бронза	о
бронзаламоқ	ф
бронламоқ	ф
бронли	с
бронтешар	о
бронх	о
бронхит	о
бронхография	о
бронхоскопия	о
бронь	о
брошюра	о
брус	о
брутто	о
бруцеллёз	о
бу	ол
бублик	о
бува	о
бувадеҳқон	о
бувак	о
буваки	о
буви	о
бувиш	о
бувра	о
бувулдуруқ	о
бугун	р,о
бугунги	с
бугунча	р
бугун-эрта	р
буд	о
будда	о
буддапарастлик	о
буддизм	о
будильник	о
будка	о
будкачи	о
буд-шуд	о
буён	у
буёқ	к
буж	о
бужмаймоқ	ф
бужмайтирмоқ	ф
бужун	о
бужур	с
бужғун	о
бузарчи	о
бузи	о
бузилиш	ф
бузилмас	с
бузилмоқ	ф
бузилувчан	с
бузмакор	о
бузмакорлик	о
бузмоқ	ф
бузоқ	о
бузоқбош	о
бузоқбоши	о
бузоқбоқар	о
бузоқламоқ	ф
бузоқлик	о
бузоқхона	о
бузоқчирг	о
бузрук	с
бузруквор	с
бузуқ	с
бузуқбош	о
бузуқ-ёриқ	с
бузуқи	о
бузуқилик	о
бузуқлик	о
бузуқчи	о
бузуқчилик	о
бузғун	с
бузғунлик	о
бузғунчи	о
бузғунчилик	о
буйдаламоқ	ф
буйра	с
буйрак	о
буйраланмоқ	ф
буйруқ	о
буйруқбоз	о
буйруқбозлик	о
буйруқнамо	с
буйруқнома	о
буйруқомуз	р
букет	о
букетламоқ	ф
букик	с
букилма	о
букилмас	с
букилмоқ	ф
букилувчан	с
буклам	с
буклама	с
букламоқ	ф
буклет	о
буклоғлик	с
букмоқ	ф
букраймоқ	ф
букри	с
букрилик	о
буксир	о
букун	р
букунги	с
букур	о
букчаймоқ	ф
бул	ол
буламиқ	о
буламоқ	ф
булбул	о
булбулак	о
булбулигўё	о
булбулнаво	с
булдирамоқ	ф
булдурғун	о
булдуруқ	о
булдуруқўт	о	
булжор	о
булка	о
буллит	о
булон	о
булоқ	о
булоқи	о
булоқчилар	о
булоғочун	о
бултур	р
бултурги	с
булут	о
булутдай	с
булутдек	с
булутланмоқ	ф
булутли	с
бульвар	о
бульденеж	о
бульдог	о
бульдозер	о
бульдозерчи	о
бульон	о
булғаламоқ	ф
булғамоқ	ф
булғанмоқ	ф
булғанч	с
булғанчиқ	с
булғатмоқ	ф
булғович	о
булғор	о
булғори	о
булғорлар	о
бумазей	о
бунақа	с
бунақанги	с
бундай	ол,р
бундайин ол,р
бундақа	ол
бундақанги	ол
бундоқ	ол,р
бунёд	о
бунёдкор	о
бунёдкорлик	о
бунёдкорона	с,р
бункер	о
бунт	о
бунча	р,ол
бунчалик	р	
бур	о
буралма	с
буралмоқ	ф
бурама	с
бурам-бурам	с
бурамоқ	ф
буранг	с
буранда	о
бурбонлар	о
бурга	о
бурган	о
бурганзор	о
бургут	о
бургутона	р
бургутсимон	с
бургутсифат	с
бурд	о
бурда	о
бурда-бурда	ф
бурдаламоқ	ф
бурда-сурда	ф
бурдли	с
бурдсиз	с
бурж	о
буржуа	о
буржуазия	о
буржуача	с
буржуй	о
бурилиш	ф
бурилмоқ	ф
бурим	о
буришиқ	о
буришмоқ	ф
буриқмоқ	ф
буркамоқ	ф
бурканмоқ	ф
бурлоқ	о
бурма	с,о
бурмабел	с
бурмабўйин	о
бурмаламоқ	ф
бурмаланиш	о
бурмаланмоқ	ф
бурмалаш	ф
бурмали	с
бурма-сурма	с
бурмақора	о
бурмоқ	ф
бурнаки	о
бурноғи	с
буров	ф
буромад	о
буроқ	о
бурро	с
бурро-бурро	р
буррон	с
бурсит	о
бурт	о
бурул	с
бурун	о,р
бурунаки	к	
бурунги	к
бурунгидай	с
бурунгича	с
бурундиқ	о
бурундор	с
бурут	о
бурушган	ф
бурушиқ	с,о
бурушиқ-тиришиқ	с
бурушмоқ	ф
буруштирмоқ	ф
бурушқоқ	с
буруқ	о
буруқсамоқ	ф
бурч	о
бурчак	о
бурчакли	с
бурчактишлар	о
бурчоқ	о
бурят	о
бурқимоқ	ф
бурқирамоқ	ф
бурқсимоқ	ф
бурқут	о
бурғи	о
бурғиламоқ	ф
бурғу	о
бус-бутун	р
бут	с,о
бута	о
бутадор	о
бутазор	о
бутамоқ	ф
бутафория	о
бут-бутун	с
бутерброд	о
бутилка	о
бутилкадош	о
бутирометр	о
бутифос	о
буткул	р
бутламоқ	ф
бутлик	о
бутоқ	о
бутоқламоқ	ф
бутпараст	о
бутпарастлик	о
бутси	о
бутун	с
бутунича	р
бутунлай	р
бутунлайин	р
бутунламоқ	ф
бутунлигича	р
бутунлик	о
бутхона	о
буфер	о
буфет	о
буфетчи	о
буфетчилик	о
буффонада	о
буханка	о
бухгалтер	о
бухгалтерия	о
бухгалтерлик	о
бухор	с
бухори	с
бухорий	с
бухорча	с,р
бухороча	с,р
бухорхудот	о
бухта	о
бушлат	о
буюк	с
буюклик	о
буюм	о
буюр	о
буюрмоқ	ф
буюрмоқ	ф
буюртирма	о
буюртма	о,с
буюртманома	о
буюртмачи	о
буюқ	о
буқа	о
буқаламун	о,с
буқаламунлик	о
буқинмоқ	ф
буқоқ	о
буқтирма	о
буқъа	о
буғ	о
буғдой	о
буғдойзор	о
буғдойиқ	о
буғдойкор	о
буғдойкорлик	о
буғдоймағиз	с
буғдойпоя	о
буғдойранг	с
буғлагич	о
буғлама	с,о
буғламоқ	ф
буғланмоқ	ф
буғланувчанлик	о
буғлаткич	о
буғли	с
буғриқмоқ	ф
буғро	о
буғролар	о
буғсимон	с
буғу	о
буғучилик	о
буғхона	о
буҳрон	о
бюджет	о
бюллетень	о
бюро	о
бюрократ	о
бюрократизм	о
бюрократик	с
бюрократия	о
бюрократларча	р
бюрократлашмоқ	ф
бюрократлик	о
бюрократча	р
бюст	о
бў	у
бўдана	о
бўёв	о
бўёвчи	о
бўёқ	о
бўёқдор	с
бўёқдорлик	о
бўёқли	с
бўёқ-сўёқ	о
бўёқхона	о
бўёқчи	о
бўёқчилик	о
бўжама	о
бўжи	о
бўз	о,с
бўза	о
бўзагар	о
бўзагарлик	о
бўзармоқ	ф
бўзафуруш	о
бўзахона	о
бўзахўр	о
бўзахўрлик	о
бўзачи	о
бўзбола	о
бўздоқ	о
бўзламоқ	ф
бўзлашмоқ	ф
бўзлик	о
бўзноч	о
бўзраймоқ	ф
бўзранг	с
бўзтикан	о
бўзтупроқ	о
бўзтўрғай	о
бўзчи	о
бўзчилик	о
бўй	о
бўй-баст	о
бўйдор	с
бўйдош	с
бўйдоқ	с
бўйдоқлик	о
бўйимодарон	о
бўйин	о
бўйинбоғ	о
бўйинтумор	о
бўйинтуруқ	о
бўйинтуруқламоқ	ф
бўйинча	о
бўйинчадўз	о
бўйича	к
бўйлаб	р
бўйламоқ	ф
бўйланмоқ	ф
бўйлашмоқ	ф
бўйли	о,с
бўйра	о
бўйрачўп	о
бўйрафуруш	о
бўйсара	о
бўйсира	о
бўйсундирмоқ	ф
бўйсунмоқ	ф
бўйсунувчанлик	о
бўйчан	с
бўйўсар	о
бўйқиз	о
бўка	о
бўкалак	о
бўкаламоқ	ф
бўкирмоқ	ф
бўкмоқ	ф
бўкса	о
бўктарги	о
бўктармоқ	ф
бўктирмоқ	ф
бўла	с,о
бўлажак	ф
бўлак	о
бўлакдан	р
бўлакламоқ	ф
бўлакча	о
бўлали	с
бўлалик	о
бўлар	ф
бўлар-бўлмас	р
бўлашмоқ	ф
бўлжор	о
бўлиб	ф
бўлиб-бўлиб	р
бўлим	о
бўлимли	с
бўлимсиз	с
бўлимча	о
бўлиниш	ф
бўлинма	о
бўлинмас	с
бўлинмоқ	ф
бўлинувчи	о
бўлис	о
бўлиш	ф
бўлишли	с
бўлишмоқ	ф
бўлишсиз	с
бўлиқ	с
бўлиқмоқ	ф
бўлка	о
бўлма	о
бўлмаган	ф
бўлмаса	ф
бўлмағур	с
бўлмиш	ф
бўлмоқ	ф
бўлса	ф
бўлтак	с
бўлтак-сўлтак	с
бўлув	ф
бўлувчи	ф
бўлук	о
бўлғуси	ф
бўм-бўш	с
бўнак	о
бўнакдор	о
бўнакчи	о
бўпти	ф
бўр	о
бўраламоқ	ф
бўрамоқ	ф
бўрбой	о
бўрдоқи	о
бўрдоқибоқар	о
бўрдоқичилик	о
бўрё	о
бўри	о
бўрибағир	о
бўрибосар	о
бўригул	о
бўрикалла	о
бўрикўз	о
бўритароқ	о
бўриқ	о
бўриқмоқ	ф
бўрк	о
бўрламоқ	ф
бўроз	о
бўрон	о
бўронли	с
бўроқуш	о
бўрсилдоқ	с
бўрсилламоқ	ф
бўрсимоқ	ф
бўрсиқ	о
бўртик	о
бўртиқ	с
бўртма	о
бўртмоқ	ф
бўртоқ	с
бўрттирмоқ	ф
бўса	о
бўсаға	о
бўстон	о
бўта	о
бўтакўз	о
бўтала	с
бўталоқ	о
бўталоқкўз	с
бўтамламоқ	ф
бўтамоқ	ф
бўтана	с
бўтаноқ	с
бўтқа	о
бўхча	о
бўхчаламоқ	ф
бўш	с
бўшалмоқ	ф
бўшамоқ	ф
бўшанг	с
бўшанглик	о
бўшанмоқ	ф
бўшанқирамоқ	ф
бўшатмоқ	ф
бўшашмоқ	ф
бўшаштирмоқ	ф
бўш-баёв	с
бўшлик	о
бўшлиқ	о
бўшоқ	с
бўштоб	с
бўштоблик	о
бўягичлар	о
бўяма	с
бўямачи	о
бўямачилик	о
бўямоқ	ф
бўяшмоқ	ф
бўқоқ	о
бўқча	о
бўғдирма	о
бўғжома	о
бўғиз	о
бўғизламоқ	ф
бўғизланмоқ	ф
бўғилмоқ	ф
бўғилтирмоқ	ф
бўғим	о
бўғимоёқлилар	о
бўғимдумлар	о
бўғин	о
бўғин-бўғин	с
бўғинли	с
бўғирсоқ	о
бўғиш	ф
бўғишма	о
бўғишмоқ	ф
бўғиқ	с
бўғма	с,о
бўғмоқ	ф
бўғов	о
бўғовламоқ	ф
бўғоз	с,о
бўғот	о
бўғра		о
бўғриқмоқ	ф
бўғувчи	ф
бўғча	о
бўҳтон	о
бўҳтончи	о
