ва	б
ваалайкум	у
вабо	о
вавағ	т
вагон	о
вагонетка	о
вагонеткачи	о
вагонлаб	р
вагонсозлик	о
вагонча	о
вагончи	о
вагранка	о
вагранкачи	о
вадаванг	т
вадаванглатмоқ	ф
важ	о
важидан	к
важ-корсон	о
важоҳат	о
важоҳатли	с
важ-тақал	о
важу	о
важҳ	о
ваза	о
вазелин	о
вазир	о
вазиру-вузаро	о
вазирлик	о
вазифа	о
вазифадор	о
вазифадош	р,с
вазият	о
вазмин	с
вазминлашмоқ	ф
вазминлик	о
вазн	о
вазндош	с
вазнли	с
вазнсиз	с
вазнсизлик	о
вайиш	о
вайрон	с
вайрона	о,с
вайронагарчилик	о
вайроназор	о
вайроналик	о
вайронгарчилик	о
вайронлик	о
вайсамоқ	ф
вайсақи	с
вайсақилик	о
вайсирамоқ	ф
вакансия	о
вакансиялар	о
вакант	с
вакил	о
вакила	о
вакилламоқ	ф
вакиллик	о
ваколат	о
ваколатдор	с
ваколатли	с
ваколатнома	о
ваколатхона	о
вакуум	о
вакуумметр	о
вакцина	о
вал	о
валад	о
валакисаланг	с
валангор	с
валақламоқ	ф
валдирамоқ	ф
валдирвасар	о
валдирвоқи	с
валенка	о
валентли	с
валентлик	о
валериана	о
валерьянка	о
валиаҳд	о
валидол	о
валий	о
валинеъмат	о
валиш	о
валламат	о
валламатлик	о
валлоҳ	м
валлоҳи	м
валфажри	о
вальвация	ф
вальс	о
валюта	о
вампир	о
вампирлар	о
ванадий	о
ванг-ванг	о
вангилламоқ	ф
вандализм	о
вандаллар	о
ванилин	о
ваниль	о
ванна	о
ваннахона	о
ванғ	т
ванғилламоқ	ф
ваража	о
варангламоқ	ф
варақ	о
варақа	о
варақ-варақ	с,р
варақи	о
варақламоқ	ф
варақли	с
варақчи	о
варвар	о
варварак	о
варваризмлар	о
варзиш	с
вариант	о
вариллаб	р
вариометр	о
варрак	о
варрант	о
варта	о
варьете	о
васваса	о
васвасали	с
васвос	с
васий	о
васийлик	о
васила	о
васият	о
васиятнома	о
васиқа	о
васиқали	с
васл	о
васса	о
вассажуфт	с
вассажуфтли	с
вассал	о
вассаллик	о
вассалом	у
васф	о
ватан	о
ватангадо	о
ватангадолик	о
ватандош	о
ватанжудолик	о
ватанли	с
ватанпарвар	с
ватанпарварлик	о
ватанфуруш	о
ватанфурушлик	о
ватар	о
ватерпас	о
ватерполист	о
ватерполо	о
ватин	о
ватман	о
ватт	о
ваттметр	о
ваучер	о
вафли	о
вафо	о
вафодор	с
вафодорлик	о
вафоли	с
вафосиз	с
вафосизлик	о
вафот	о
вахли	с
вахлик	с
вахта	о
вахтёр	о
вашилламоқ	ф
ваъда	о
ваъдабоз	о
ваъдабозлик	о
ваъдалашмоқ	ф
ваъдасиз	с
ваъз	о
ваъз-насиҳат	о
ваъзхон	о
ваъзхонлик	о
ваъзчи	о
вақ-вақ	т
вақилламоқ	ф
вақир-вақир	т
вақирламоқ	ф
вақо	о
вақт	о
вақтбай	с
вақт-бевақт	р
вақт-вақт	р
вақтида	р
вақтинча	р
вақтинчалик	р
вақтихушлик	о
вақтичоғлик	о
вақтли	с
вақтсиз	р
вақт-соати	о
вақти-соати	о
вақф	о
вақфнома	о
вақфхўр	о
вағилламоқ	ф
вағир-вуғур	т
вағирламоқ	ф
ваҳ	у
ваҳдат	о
ваҳдоният	о
ваҳий	о
ваҳим	о
ваҳима	о
ваҳималанмоқ	ф
ваҳимали	с
ваҳимачи	о
ваҳм	о
ваҳма	о
ваҳмак	о
ваҳмақуш	о
ваҳмкор	с
ваҳоланки	б
ваҳшат	о
ваҳшатли	с
ваҳшиёна	р
ваҳший	с
ваҳшийларча	р
ваҳшийлашмоқ	ф
ваҳшийлик	о
ваҳҳобий	о
ваҳҳобийлик	о
вегетарианлик	о
вегетатив	с
вегетацион	с
вегетация	о
ведалар	о
ведомость	о
вездеход	о
вей	у
вексель	о
вектор	о
велодром	о
велопойга	о
велосипед	о
велосипедчи	о
велоспорт	о
велотрек	о
велюр	о
веналар	о
венгер	о
венгерлар	о
венепункция	о
венера	о
венерик	с
венеролог	о
венерология	о
вентиль	о
вентилятор	о
вентиляцион	с
вентиляция	о
вергул	о
вердикт	о
вермишель	о
вернисаж	о
верньер	о
версия	о
верстак	о
вертикал	о,с
вертолёт	о
верфь	о
вершок	о
вестерн	о
вестибюль	о
ветврач	о
ветеран	о
ветеринар	о
ветеринария	о
вето	о
вешалка	о
вёрстка	о
взвод	о
взнос	о
вибратор	о
вибрация	о
вибро-	с
виброболға	о
виброизоляция	о
виброметр	о
вибротўқмоқ	о
виброғалвир	о
вивеска	о
виговор	о
видео	с,о
видеоаппаратура	о
видеобар	о
видеоёзув	о
видеоканал	о
видеокассета	о
видеокучайтиргич	о
видеомагнитофон	о
видеосалон	о
видеосериал	о
видеотасвир	о
видеотека	о
видеотелефон	о
видеотехника	о
видеофильм	о
видеочи	о
видо	о
видолашмоқ	ф
виж-виж	т
виждон	о
вижнонан	р
виждоний	с
виждонли	с
виждонсиз	с
виждонсизлик	о
вижилламоқ	ф
вижир-вижир	т
вижирламоқ	ф
виз	т
виза	о
визвизак	о
визилдоқ	о
визилламоқ	ф
визир	ф
визит	о
визитка	о
визуал	с
виключатель	о
виконт	о
викторина	о
вилка	о
вилла	о
вилоят	о
вилт	о
вимпел	о
виндикация	о	
винегрет	о
вино	о
виночи	о
виночилик	о
винт	о
винтовка	о
винтсимон	с
виньетка	о
виолончель	о
вираж	о
вирилизм	о
виртуоз	о
вируслар	о
вирусли	с
вирусология	о
висир-висир	т
висирламоқ	ф
виски	о
вискоза	о
вискозиметр	о
вискозиметрия	о
висмут	о
висол	о
виставка	о
вит	т
витамин	о
витаминли	с
вит-вит	т
витраж	о
витрина	о
вице-	с
вице-адмирал	о
вице-президент	о
виш	т
вишилламоқ	ф
вишка	о
виқор	о
виқорли	с
включатель	о
воажаб	у
воажабо	у
вобаста	с
вов	т
вовайлато	у
вовайло	у
вовилламоқ	ф
водариғ	у
водариғо	у
водевиль	о
водий	о
водовоз	о
водоканал	о
водокачка	о
водолаз	о
водопровод	о
водопроводчи	о
водород	о
воей	у
военком	о
военкомат	о
вожак	о
вожатий	о
вожиб	о
воз	ф
воиз	о
воизлик	о
вой	у
войбў	у
войбўй	у
войвойламоқ	ф
войдод	у
войдодламоқ	ф
вокал	с
вокализм	о
вокалист	о
вокзал	о
вола	о
волан	о
волапюк	о
волдир	о
волейбол	о
волейболчи	о
волида	о
волидайн	о
воли	о
волий	о
волость	о
вольт	о
вольта	о
вольтли	с
вольтметр	о
вольфрам	о
волюнтаризм	о
волюнтарист	о
волюнтаристик	с
вона	о
вориллаб	р
ворис	о
ворислик	о
воронка	о
восил	о
восита	о
воситали	с
воситасиз	с
воситачи	о
воситачилик	о
вотум	о
вофуруш	о
воя	о
воқе	с
воқеъ	с
воқеа	о
воқеан	р
воқеанавис	о
воқеий	с
воқелик	о
воқиф	с
воҳ	у
воҳа	о
воҳасрато	у
воҳид	сн,о
врач	о
врачлик	о
вужуд	о
вужудият	о
вузаро	о
вуй	у
вулкан	о
вулканизация	о
вулканология	о
вульгар	с
вульгаризм	о
вульгарлаштирмоқ	ф
вулқон	о
