габардин	о
габарит	о
габбро	о
габр	о
гаваз	о
гавань	о
гавара	о
гавра	о
гавда	о
гавдаланмоқ	ф
гавдали	с
гавжум	с
гавжумлашмоқ	ф
гавир	о
гавирлик	о
гаврапўш	о
гаврон	о
гавронламоқ	ф
гавҳар	о
гавҳарафшон	о
гавҳаршунос	о
гагаралар	о
гагауз	о
гагаузлар	о
гадо	о
гадобачча	о,с
гадой	о
гадойвачча	о
гадойлик	о
гадойчилик	о
гадолик	о
гадолиний	о
гаж	с
гажак	о,с
гажакдор	с
гажакли	с
гажим	о
гажимдор	с
гажимли	с
гажир	с
гажирлик	о
газ	о
газа	о
газак	о
газакламоқ	ф
газан	о
газанда	о
газандалик	о
газат	о
газет	о
газета	о
газетачи	о
газетхонлик	о
газетчи	о
газик	о
газлама	о
газламафуруш	о
газламоқ	ф
газлашмоқ	ф
газлаштирмоқ	ф
газли	с
газмол	о
газниқоб	о
газогенератор	о
газолин	о
газон	о
газопровод	о
газплита	о
газсимон	с
газсув	о
газчи	о
газчўп	о
газўчоқ	о
гайка	о
гайморит	о
гал	о
гала	о
галагов	о
галактик	с
галактика	о
галалашмоқ	ф
галантерея	о
галварс	с
галварслик	о
галги	с
галгидай	р
галгидек	р
галдаги	с
галдир	о
галдиракламоқ	ф
галдирамоқ	ф
галерея	о
галифе	о
галламоқ	ф
галлий	о
галлицизм	о
галлюцинация	о
галма-гал	р
галогенлар	о
галоид	о
галофитлар	о
галстук	о
гальванизация	о
гальваник	с
гальванометр	о
гамадрил	о
гамак	о
гамбит	о
гамбургер	о
гамма	о
ган	о
ганак	о
ганг	ф
гангимоқ	ф
гангирамоқ	ф
гангирбош	о
гангир-гунгур	о
гангитмоқ	ф
гарграмоқ	ф
гангрена	о
гангстер	о
ганда	о
гандбол	о
гандиракламоқ	ф
ганж	о
ганжина	о
гантель	о
ганч	о
ганчкор	о,с
ганчкорлик	о
ганчламоқ	ф
гап	о
гапбозлик	о
гап-гаштак	о
гап-гурунг	о
гапдон	с
гапдонлик	о
гапиришмоқ	ф
гапирмоқ	ф
гаплашмоқ	ф
гапсотар	о
гап-сўз	о
гапхона	о
гапхўр	о
гапхўрлик	о	
гапчи	с
гапчил	с
гар	б
гараж	о
гаразон	с
гаранг	с
гаранглик	о
гарангсимоқ	ф
гарангтоб	с
гарантия	о
гарантияламоқ	ф
гарбил	о
гард	о
гардан	о
гарданкаш	с
гарданкашлик	о
гард-гард	т
гарддай	сн
гардероб	о
гардеробхона	о
гардеробчи	о
гардин	о
гардиш	о
гардкам	у
гардун	о
гард-тўзон	о
гард-чанг	о
гард-қурум	о
гард-ғубор	о
гарма	о
гармдори	о
гармиён	о
гармонлик	с
гармония	о
гармончи	о
гармонь	о
гармсар	о
гармсел	о
гарнизон	о
гарнир	о
гарнитур	о
гаров	о
гаровхона	о
гарчанд	б
гарчи	б
гастрит	о
гастролёр	о
гастроль	о
гастроль-концерт	о
гастроном	о
гастроэнтерит	о
гастроэнтерология	о
гаубица	о
гауптвахта	о
гафний	о
гашир	о
гашт	о
гаштак	о
гашти	р
гаштли	с
гаҳ	у
гаҳи	р
гвардия	о
гвардиячи	с
гегемон	о
гегемонлик	о
гезармоқ	ф
гейзер	о
гейм	о
гейша	о
геккон	о
гексахлоран	о
гексаэдр	о
гектар	о
гектарчи	о
гекто-	сн
гектограф	о
гектографик	с
гелагай	о
гелий	о
гелио-	о
гелиотерапия	о
гелиотехника	о
гелиотроп	о
гелиофизика	о
гелиоцентрик	с
гелламоқ	ф
гельминт	о
гельминтоз	о
гельминтология	о
гем	о
гематит	о
гематология	о
гемината	о
гемо-	с
гемоглобин	о
гемодез	о
гемометр	о
геморрой	о
гемотерапия	о
ген	о
генеалогик	с
генеалогия	о
генезис	о
генерал	о,с
генерал-губернатор	о
генералиссимус		о
генералитет	о
генерал-лейтенант	о
генерал-майор	о
генерал-полковник	о
генератор	о
генетик	о,с
генетика	о	
гениал	с
гениаллик	о
гений	с,о
генийлик	о
генофонд	о
геноцид	о
гео-	с
геоботаника	о
географ	о
географик	с
география	о
геодезик	с
геодезист	о
геодезия	о
геокимё	о
геокимёвий	с
геолог	о
геологик	с
геология	о
геометрик	с
геометрия	о
геоморфологик	с
геоморфология	о
геополитик	с
геополитика	о
геосиёсат	о
геосиёсий	с
геостратегик	с
геосфера	о
геофизик	о,с
геофизика	о
геофон	о
геохимик	с
геохимия	о
геоцентрик	о
гепард	о
гепатит	о
геральдика	о
герб	о
гербарий	о
гербицидлар	о
гербшунослик	о
гердаймоқ	ф
гериатрия	о
герма	о
герман	о
германизм	о
германий	о
германист	о
германистика	о
германлар	о
герметик	с
герметиклик	о
героин	о
геронтология	о
герц	о
герцог	о
гестапо	о
гестапочи	о
гетман	о
гетра	о
гиацинт	о
гиббон	о
гибрид	о
гибридлаш	ф
гибридламоқ	ф
гигант	с
гигиена	о
гигиеник	с
гигро-	с
гигрометр	о
гигроскопик	с
гид	о
гидир	о
гидравлик	с
гидравлика	о
гидрант	о
гидратланиш	о
гидратлар	о
гидремия	ф
гидридлар	о
гидро-	с
гидроакустика	о
гидробиология	о
гидрогенератор	о
гидрогеолог	о
геидрогеологик	с
гидрогеология	о
гидродинамик	с
гидродинамика	о
гидроизолятор	о
гидроиншоот	о
гидрокимё	о
гидрокортизон	о
гидролиз	о
гидролизчи	о
гидролог	о
гидрологик	с
гидрология	о
гидролокатор	о
гидромелиоратив	с
гидромелиоратор	о
гидромелиорация	о
гидрометеорология	о
гидромеханизация	о
гидромеханика	о
гидронасос	о
гидроним	о
гидроподъёмник	о
гидропоника	о
гидросамолёт	о
гидростанция	о
гидростат	о
гидростатик	с
гидростатика	о
гидросфера	о
гидротерапия	о
гидротехник	о,с
гидротехника	о
гидротурбина	о
гидроузел	о
гидрофизика	о
гидроэлектростанция	о
гидроэнергетик	с
гидроэнергетика	о
гиё	о
гиёҳ	о
гиёҳванд	о
гиёҳвандлик	о
гижбанг	т
гижбанглатмоқ	ф
гижгижламоқ	ф
гижда	о
гиждапаз	о
гижжалар	о
гижинг	с
гижингламоқ	ф
гил	о
гилам	о
гиламбоф	о
гиламгул	о
гиламдўз	о
гиламдўзлик	о
гиламфуруш	о
гиламчилик	о
гилвата	о
гилкор	о
гилкорлик	о
гилмоя	о
гилос	о
гилосзор	о
гильза	о
гимн	о
гимназист	о
гимназия	о
гимнаст	о
гимнастёрка	о
гимнастика	о
гимнастикачи	о
гина	о
гина-гудрат	о	
гина-гудур	о
гинадор	с
гина-кудурат	о
гиналамоқ	ф
гинали	с
гинаомуз	с
гинахонлик	о
гиначи	о
гиначилик	о
гингивит	о
гинеколог	о
гинекологик	с
гинекология	о
гипер-	с
гипербола	о
гиперболик	с
гипервитаминоз	о
гиперемия	о
гиперинфляция	о
гипертермия	о
гипертоник	о,с
гипертония	о
гипертрофия	о
гиперфазо	о
гипноз	о
гипнозламоқ	ф
гипнозчи	о
гипо-	с
гиповитаминоз	о
гипокинезия	о
гипосульфит	о
гипотеза	о
гипотенуза	о
гипотермия	о
гипотония	о
гипотрофия	о
гипофиз	о
гипоцентр	о
гиппология	о
гиппопотам	о
гипс	о
гипсламоқ	ф
гир	о
гира	о
гирак	р
гиракламоқ	ф
гиранда	с
гир-гир	т
гиргиттон	у
гирд	о
гирдак	с
гирд-атроф	о
гирдбод	о
гирдибод	о
гирдикапалак	о
гирдиғум	с
гирдоб	о
гирдогирд	о
гирён	ф
гирёна	ф
гирибон	о
гирифтор	ф
гириш	о
гириҳ	о
гирра	о
гиря	о
гистолог	о
гистологик	с
гистология	о
гитара	о
гитарачи	о
гладиатор	о
гладиолус	о
глаукома	о
глицерин	о
глобал	с
глобаллашув	о
глобус	о
глоссарий	о
глюкоза	о
гляциолог	о
гляциология	о
гносеологик	с
гносеология	о
го	б
гобелен	о
гобой	о
гов	с
говвос	о
говгун	р
говмижжа	о
говмиш	о
говрон	о
гож	с
гожлик	о
гол	о
голкипер	о
голланд	о
голландлар	о
голографик	с
голография	о
гольф	о
гоммоз	о
гомоген	с
гомосексуализм	о
гонг	о
гондола	о
гониометр	о
гонорар	о
горельеф	о
горелка	о
горизонт	о
горизонтал	с
горизонталь	с,о
горилла		о
гормон	о
горн	о
горнчи	о
городки	о
городовой	о
гороскоп	о
горчица	о
горчичник	о
госпиталь	о
готик	с
готика	о
гоҳ	б
гоҳ-гоҳ	р
гоҳи	р
гоҳида	р
гоҳо	р
гравитация	о
гравюра	о
градация	о
градус	о
градусник	о
граждан	о
гражданин	о
гражданлик	о
грамм	о
грамматик	с
грамматика	о
грамматикалашиш	ф
граммофон	о
грампластинка	о
граната	о
гранатомёт	о
гранатомётчи	о
гранит	о
гранка	о
гран-при	о
грант	о
граф	о
графа	о
график	о,с
графика	о
графин	о
графиня	о
графит	о
графлик	о
графолог	о
графология	о
грейдер	о
грек	о
греклар	о
грелка	о
гречиха	о
гривна	о
грим	о
гримхона	о
гримчи	о
грипп	о
гриф	о
грифель	о
грифон	о
гроссмейстер	о
гротеск	о
грузин	о
грузинлар	о
грузинча	с
грузовик	о
грунт	о
грунтшунослик	о
группа	о
группабоз	о
группабозлик	о
гуашь	о
губер	о
губерна	о
губерня	о
губернатор	о
гув	т
гувала	о
гувалак	с
гувламоқ	ф
гувоҳ	о
гувоҳлантирмоқ	ф
гувоҳлик	о
гувохнома	о
гувулламоқ	ф
гувранмоқ	ф
гугурт	о
гугуртчўп	о
гудок	о
гудрон	о
гудронатор	о
гужум	о
гузар	о
гузаргоҳ	о
гул	о
гула	о
гулабардор	о
гуландом	с
гулбадан	о
гулбарг	о
гулбаҳор	о
гулбеор	о
гулбоғ	о
гулгай	о
гул-гул	с
гулгун	с
гулдай	с
гулдаста	о
гулдон	о
гулдор	с
гулдур	т
гулдурак	о
гулдурамоқ	ф
гулдурос	с
гулдур-шалдир	р
гулдўз	о
гулдўзи	с
гулетим	о
гулёр	о
гулжабин	с
гулзор	о
гулистон	о
гулисумбул	о
гулкарам	о
гулкор	о
гулкоса	о
гулкўрпа	о
гулламоқ	ф
гуллатмоқ	ф
гулли	с
гулмих	о
гулмоҳи	о
гулнор	о,с
гулнора	о
гулоб	о
гулоби	с
гулобчи	о
гулраъно	о
гулрух	с
гулрў	с
гулсапсар	о
гултож	о
гултожбарг	о
гултожихўроз	о
гултувак	о
гулузор	с
гулута	о
гулхайри	о
гулхан	о
гулханчи	о
гулхона	о
гулчамбар	о
гулчелак	о
гулчеҳра	с
гулчи	о
гулчилик	о
гулчин	о
гулчирой	с,о
гулшан		о
гулшода	о
гулюз	с,о
гуляш	о
гулқайчи	о
гулқанд	о
гулқоғоз	о
гулғунча	о
гулҳамишабаҳор	о
гум	с,о
гуманизм	о
гуманист	о
гуманистик	с
гуманитар	с
гумашта	о
гумбаз	о
гумбаздай	с
гумбазсимон	с
гумбур	т,с
гумбурлама	ф
гумбурламоқ	ф
гумбурлатмоқ	ф
гум-гум	т
гумдон	ф
гумон	о
гумона	о
гумондор	о
гумонламоқ	ф
гумонсирамоқ	ф
гумроҳ	ф
гумроҳлик	о
гумурмоқ	ф
гумус	о
гунафша	о
гунг	с
гунгалак	с
гунгур-гунгур	т
гунгурсдай	с
гунгурсдек	с
гунгурт	с
гуногун	с
гуноҳ	о
гуноҳкор	о
гуноҳкорона	р
гуп	т
гуп-гуп	р
гупилламоқ	ф
гуппа	т
гуппаклашмоқ	ф
гуппа-гуппа	р
гуппи	с,о
гупсар	о
гупурмоқ	ф
гупчак	о
гупчакдай	с
гупчакдек	с
гур	т
гурас-гурас	р
гурвак	о
гурд	с
гурдалик	с
гуржи	о
гурзи	о
гурилламоқ	ф
гуркирамоқ	ф
гурпаклашмоқ	ф
гурра	т
гуррос-гуррос	т
гурс	т
гурсилламоқ	ф
гурскетди	о
гурунг	о
гурунглашмоқ	ф
гурунч	о
гуруч	о
гуруҳ	о
гуруҳбоз	о
гуруҳбозлик	о
гуруҳламоқ	ф
гусар	о
гусеница	о
гусли	о
густох	с
густохлик	о
гусубурида	о
гусур-гусур	т
гуталин	о
гуттаперча	о
гуфтугў	о
гушна	с
гуҳар	о
гўдак	о
гўдакларча	р
гўдаклик	о
гўё	б,о
гўёки	б
гўжа	о
гўзал	с
гўзаллашмоқ	ф
гўзаллик	о
гўл	с
гўлаймоқ	ф
гўлах	о
гўлахи	о
гўлаххона	о
гўллик	о
гўлос	с
гўмма	о
гўнг	о
гўнгламоқ	ф
гўнгхона	о
гўнгқарға	о
гўния	о
гўпсанги	о
гўр	о
гўрга	м
гўристон	о
гўристонлик	о
гўрков	о
гўрковчи	о
гўрсўхта	о
гўрхона	о
гўсноғора	о
гўсфанд	о
гўсхўр	о
гўш	о
гўша	о
гўшак	о
гўшанга	о
гўшанишин	о
гўшанишинлик	о
гўшт	о
гўштгирлик	о
гўштдор	с
гўшткуйди	о
гўштли	с
гўштсиз	с
гўштхўр	с
гўянда	о