ебир-есир	о
еб-ичмоқ	ф
ебтўймас	с
еврей	о
евро	о
егилук	о
егулик	о
егулик-ичгулик	о
едирмоқ	ф
езна	о
ейилиш	ф
ейилмоқ	ф
ейимли	с
ейимлик	о
ейишли	с
ел	о
елвагай	о
елвизак	о
елдирим	о
елиб-югурмоқ	ф
елик	о
еликиш	ф
еликмоқ	ф
елим	о
елимбалиқ	о
елимламоқ	ф
елин	о
елка	о
елкадор	с
елкадош	о
елкаламоқ	ф
елкали	с
елкама-елка	р
елкан	о
елмоя	о
елмоқ	ф
елпатак	о
елпимоқ	ф
елпиштовоқ	о
елпиғич	о
елқанот	с
ем	о
емак	о,ф
емакхона	о
емирмоқ	ф
емиш	о
емламоқ	ф
емоқ	ф
емсак	с
емтик	о
ем-хашак	о
енг	о
енгил	с
енгил-елпи	с,р
елгил-елпилик	о
енгилламоқ	ф
енгилланмоқ	ф
енгиллатмоқ	ф
енгиллашмоқ	ф
енгиллик	о
енгилмас	ф
енгилмоқ	ф
енгилтак	с
енгилтаклик	о
енглик	о
енгмоқ	ф
енгсак	о
енгча	о
епископ	о
ер	о
ердор	о
ерёнғоқ	о
ер-кўк	о
ерламоқ	ф
ерли	с
ерлик	с,о
ерлилаштирмоқ	ф
ерли-сувли	с
ерпарчин	с
ерсиз	с
ертандир	о
ертўла	о
есир	о
етак	о
етаки	с
етакламоқ	ф
етаклашмоқ	ф
етакчи	о
етакчилик	о
етар-етмас	р
етарли	с
етилмоқ	ф
етим	с
етимвачча	о
етим-есир	о
етимлик	о
етимхона	о
етимпарвар	с
етимхона	о
етимча	о
етишмовчилик	о
етишмоқ	ф
етиштирмоқ	ф
етказмоқ	ф
етмак	ф
етмиш	о,сн
етмоқ	ф
етов	о
етти	сн,о
еттилик	с
етук	с
етуклик	о
ефрейтор	о
ечилмоқ	ф
ечим	о
ечинмоқ	ф
ечинтирмоқ	ф
ечиқ	с
ечмоқ	ф
ечтирмоқ	ф
ешмоқ	ф