жа	c
жабазак	c
жаббор	c,о
жабдуқ	о
жабдуқламоқ	ф
жабр	о
жабра	о
жабран	р
жабрдийда	с
жабр-жафо	о
жабр-зулм	о
жабрламоқ	ф
жабрланмоқ	ф
жабрланувчи	о
жабр-ситам	о
жабҳа	о
жавак	о
жавгаза	о
жавгазим	о
жавдар	о
жавдари	о
жавдирамоқ	ф
жавдир-жавдир	т
жавдироқ	с
жавзо	о
жавлон	о
жавоб	о
жавобан	р
жавобгар	о
жавобгарлик	о
жавоб-муомала	о
жавобнома	о
жавобсиз	с,р
жавон	о
жавонмардлик	о
жавониб	о
жавонғор	о
жавоҳир	о
жавоҳирот	о
жавпазак	с
жаврамоқ	ф
жаврақи	с
жавҳар	о
жавҳарлиму	о
жад	о
жадал	р
жадалламоқ	ф
жадаллик	о
жадвал	о
жадд	о
жадди	о
жадид	о
жадидизм	о
жадидчилик	о
жадий	о
жадй	о
жажақламоқ	ф
жажжи	с
жажман	с
жаз	о,т
жазава	о
жазб	о
жазбар	о
жаз-буз	т
жазвал	о
жаз-жаз	т
жаз-жуз	т
жазза	о
жазиллама	с
жазилламоқ	ф
жазиллатмоқ	ф
жазира	с,о
жазирама	с,о
жазлиқ	о
жазм	о
жазман	о
жазмланмоқ	ф
жазо	о
жазойил	о
жазойир	о
жазоламоқ	ф
жайб	о
жайдари	с
жайнамоқ	ф
жайра	о
жайран	о
жайрон	о
жайҳун	о
жакет	о
жакетка	о
жала	о
жалаламоқ	ф
жалангламоқ	ф
жалб	о
жаллоб	о
жаллоблик	о
жаллод	о
жаллодлик	о
жалойир	о
жалойирлар	о
жалюза	о
жам	о
жамалак	о
жамарға	о
жамбил	о
жами	к
жамики	ол
жамила	с,о
жамият	о
жамиятшунослик	о
жамламоқ	ф
жамловчи	с
жамоя	о
жамоат	о
жамоатчи	о
жамоатчилик	о
жамол	о
жамулжам	к
жамғарма	о
жамғармоқ	ф
жана	о
жаналатмоқ	ф
жанбил	о
жанг	о
жангари	с
жангарилик	о
жанггоҳ	о
жанг-жадал	о
жангдовул	о
жангилламоқ	ф
жангир-жунгур	т
жангкарнай	о
жангнома	о
жанговар	о,с
жанговарлик	о
жангсиз	р
жангчи	о
жанда	о
жандапўш	о
жандарм	о
жандарма	о
жандармерия	о
жанжал	о
жанжалкаш	с
жанжалкашлик	о
жанжаллашмоқ	ф
жанжалли	с
жанжалсиз	р
жанжал-сурон	о
жанжалчи	о
жаннат	о
жаннати	с
жаноб	о
жаннатмакон	с
жаннатмонанд	с
жаннатсимон	с
жаноза	о
жанр	о
жануб	о
жанубий	с
жануби-шарқ	о
жануби-шарқий	с
жануби-ғарб	о
жануби-ғарбий	с
жапс	с
жапсак	о
жар	о
жараён	о
жаранг	т
жарангдор	с
жаранг-журунг	т
жаранглама	с
жарангламоқ	ф
жарангли	с
жарангсиз	с
жарақ-жарақ	т
жарақламоқ	ф
жарақлатмоқ	ф
жаргон	о
жар-жулға	о
жарида	о
жарилламоқ	ф
жарима	о
жаримадор	о
жаркоп	о
жарлик	о
жароҳат	о
жароҳатламоқ	ф
жароҳатли	с
жарроҳ	о
жарроҳлик	о
жарроҳхона	о
жарчи	о
жарқалдирғоч	о
жарқанот	о
жарғи	о
жасад	о
жасорат	о
жасоратланмоқ	ф
жасоратли	с
жасоратсизлик	о
жасур	с
жасурланмоқ	ф
жасурлик	о
жасурона	р
жат	о
жафо	о
жафодийда	с
жафокаш	с
жафокашлик	о
жафокор	с
жафокорлик	о
жафоланмоқ	ф
жафоли	с
жағ	о
жағдай	о
жағжағ	о
жағилламоқ	a
жаҳалдирик	о
жаҳаннам	о
жаҳд-жадал	о
жаҳл	о
жаҳлдор	с
жағлланмоқ	ф
жаҳлли	с
жаҳолат	о
жаҳолатпараст	о
жаҳон	о
жаҳонбахш	с
жаҳонгашта	с
жаҳонгашталик	о
жаҳонгир	с
жаҳонгирлик	о
жаҳондийда	с
жаҳондор	о
жаҳон-жаҳон	сн
жаҳоний	с
жаҳоннамо	о
жаҳоншумул	с
жаҳр	о
жаҳрия	о
жгут	о
жева	о
жевак	о
жевахона	о
жевачи	о
жез	о
жезл	о
жезна	о
жек	с
жекирмоқ	ф
жел	о
жела	о
желак	о
желатин	о
желатка	о
жем	о
жемпер	о
женьшень	о
жеркмоқ	ф
жетон	о
жеблажибон	о
живилламоқ	ф
живир-живир	т
живирламоқ	ф
жигар	о
жигарбанд	о
жигар-бағир	о
жигаргўша	о
жигарпора	о
жигарранг	с
жигарсўхта	с
жигархун	о
жигарчилик	о
жиги-жиги	у
жигилдак	о
жигилламоқ	ф
жидд	о
жиддий	с
жиддийлашмоқ	ф
жиддийлик	о
жиддият	о
жиз	т,о
жиз-биз	т
жиз-жиз	т
жизза	о
жиззаки	с
жиззакилик	о
жиззахўрлик	о
жиззиқ	о
жизилламоқ	ф
жизя	о
жизғанак	с,о
жизғинак	с,о
жизғин	с,о
жийда	о
жийдагул	о,с
жийдазор	о
жийда-майиз	о
жийдаяпроқ	о
жийирмоқ	ф
жиймоқ	ф
жийрон	о
жийронқашқа	о
жийронқуш	о
жикжик	о
жикилдоқ	с
жикилламоқ	ф
жикиллашмоқ	ф
жиккак	с
жиктоқ	о
жилавуқ	с
жиламоқ	ф
жилва	о
жилвагар	с
жилвадор	с
жилвакор	с
жилвали	с
жилвир	с
жилвирламоқ	ф
жилд	о
жилдирамоқ	ф
жилдирмоқ	ф
жилдламоқ	ф
жилдли	с
жилдлик	с
жилет	о
жилетка	о
жилла	сн
жилмаймоқ	ф
жилмоқ	ф
жило	о
жилов	о
жиловбардор	о
жиловдор	о
жиловламоқ	ф
жиловсиз	с
жиловхона	о
жилоламоқ	ф
жилоланмоқ	ф
жилпангламоқ	ф
жилпитмоқ	ф
жилға	о
жим	р
жимгина	р
жимжилоқ	о
жимжилоқдай	с
жимжилоқдек	с
жимжима	о
жимжимадор	с
жимжимадорлик	о
жимжит	р
жимжитлик	о
жимилламоқ	ф
жимимоқ	ф
жимир	т
жимир-жимир	т
жимирламоқ	ф
жимирлашмоқ	ф
жимит	с
жимиқмоқ	ф
жимлик	о
жимма-жимма	сн
жин	о
жинг	р
жингак	о
жингала	с,о
жингалак	с,о
жингилламоқ	ф
жингир-жиргир	т
жингирламоқ	ф
жингиртоб	с
жингул	о
жиндай	р
жиндек	р
жинжак	о
жинжалоқ	о
жинка	с
жинни	о
жиннивачча	о
жиннивой	о
жиннилик	о
жинни-минни	о
жинни-пинни	о
жиннинамо	с
жиннисанғи	с
жиннихона	о
жиноий	с
жиноий-процессуал	с
жиноят	о
жинояткор	о
жинояткорлик	о
жинояткорона	р
жиноятчи	о
жиноятчилик	о
жинс	о
жинсдош	о
жинси	о
жинсий	с
жинчироқ	о
жинқарча	о
жинғил	о
жинғирламоқ	ф
жинғироқ	о
жипс	р
жипсламоқ	ф
жипслашмоқ	ф
жипслик	о
жир	о
жирафа	о
жирилламоқ	ф
жиринг	т
жирингламоқ	ф
жириш	о
жирканмоқ	ф
жирканувчан	с
жирканч	с
жирламоқ	ф
жиров	о
жиронғор	о
жирраки	с
жирракилик	о
жиртак	о
жиртаки	с
жиртакилик	о
жиртилламоқ	ф
жисм	о
жисман	р
жисмонан	р
жисмоний	с
жичча	сн
жиш	о
жияк	о
жиякфуруш	о
жиян	о
жиқ	т
жиқ-жиқ	т
жиқиллашмоқ	ф
жиққа	т
жиққамуш	о
жиққамушт	т
жиғ	т
жиға	о
жиғавул	о
жиғадор	с
жиғибийрон	с
жиғилдон	о
жиғилламоқ	ф
жиғиллашмоқ	ф
жиғовул	о
жиғолтой	о
жиҳат	о
жиҳатдан	к
жиҳод	о
жиҳоз	о
жиҳозламоқ	ф
жо	ф
жобажо	ф
жобир	о
жовдирамоқ	ф
жовлик	р
жовидон	с
жовон	о
жоди	о
жоду	о
жодугар	о
жодугарлик	о
жозиб	о
жозиба	о
жозибадор	с
жозибадорлик	о
жозибали	с
жоиз	с
жой	о,р
жойида	р
жойламоқ	ф
жойлашмоқ	ф
жойлашмоқ	ф
жойлаштирмоқ	ф
жойли	с
жойнамоз	о
жойраво	о
жойсиз	с,р
жойсизлик	о
жойхоб	о
жола	о
жом	о
жома	о
жомадон	о
жомакор	о
жомашов	о
жомбиз	о
жоме	о
жомиул-улум	о
жон	о
жонажон	с
жонбахш	с
жонбоз	с
жонбозлик	о
жонгинам	о
жонглёр	о
жон-дил	о
жондор	о
жондош	с
жон-жаҳд	о
жон-жаҳон	о
жонзот	о
жониб	о
жонивор	о
жоним	о
жон-тан	о
жониқмоқ	ф
жонкаш	с
жонкашлик	о
жонкуяр	с
жонкуярлик	о
жонланиш	ф
жонланмоқ	ф
жонли	с
жонлилик	о
жонлиқ	о
жонон	о
жонона	о
жоноқи	с
жонпарвар	о
жон-пон	о
жонсарак	с
жонсараклик	о
жонсиз	с
жонсизланмоқ	ф
жонсизлантирмоқ	ф
жонсизлик	о
жонсўз	с
жонсўхта	с
жон-тан	о
жонфидо	с
жонфидолик	о
жонҳалак	с
жон-ҳол	о
жорий	с
жория	о
жосус	о
жосуслик	о
жоҳил	с
жоҳиллик	о
жубба	о
жувда	о
жувоз	о
жувозкаш	о
жувозкашлик	о
жувозхона	о
жуволдиз	о
жувон	о
жувона	о
жувонбахт	с
жувонбоз	о
жувонбозлик	о
жувонлик	о
жувонмарг	о
жувонмард	с
жувонмардлик	о
жувори	о
жувонсўхта	с
жуда	р
жудаям	р
жудо	ф
жудолик	о
жужун	о
жужунча	о
жужуқ	о
жуз	о
жузв	о
жузвдон	о
жузгир	о
жуздон	о
жузламоқ	ф
жузъий	с
жузғун	о
жуйрук	о
жул	о,с
жулдур	с
жулдурвоқи	с,о
жулпат	о
жулхирс	о
жума	о
жумак	о
жумалик	о
жумард	с
жумаҳшанба	о
жумбоқ	о
жумла	о
жумладан	м
жумласидан	м
жумодилаввал	о
жумодилохир	о
жумодиссони	о
жумодиссоний	о
жумрушқа	о
жумур	о
жумъа	о
жумҳурият	о
жун	о
жунбиш	ф
жунгли	о
жунжаймоқ	ф
жунжикмоқ	ф
жунжимоқ	ф
жунун	о
жунунваш	с
жунғорлар	о
журм	о
журнал	о
журналист	о
журналистика	о
журналистка	о
журналхон	о
журъат	о
жусса	о
жуссадор	с
жуссали	с
жут	о
жуфай	р
жуфт	о
жуфтак	о
жуфтламоқ	ф
жуфтлашмоқ	ф
жуфтлаштирмоқ	ф
жуфтлик	о
жуғрофий	с
жуғрофия	о
жуғрофиюн	о
жуҳуд	о
жюри	о
жўва	о
жўваламоқ	ф
жўгари	о
жўги	о
жўжа	о
жўжабирдай	с
жўжабирдек	с
жўжаламоқ	ф
жўжахўроз	о
жўжилар	о
жўйбор	о
жўймоқ	ф
жўка	о
жўлак	о
жўмард	с
жўмардлик	о
жўмрак	о
жўн	с
жўналиш	о
жўнамоқ	ф
жўнашмоқ	ф
жўнағай	о
жўнг	о
жўнига	к
жўнидан	к
жўнликча	р
жўпламоқ	ф
жўр	о,с
жўра	о
жўрабоши	о
жўрабошилик	о
жўралашмоқ	ф
жўрамоқ	ф
жўрақанд	о
жўровоз	с
жўрттага	р
жўрчи	о
жўхори	о
жўхоризор	о
жўхорикор	о
жўхорикорлик	о
жўхорипоя	о
жўш	ф
жўшмоқ	ф
жўшқин	с
жўшқинлик	о
жўя	о
жўяк	о
жўяли	с
жўясиз	с
жўқчилар	о