иби	у
иблис	о
иблисларча	р
иблислик	о
иблисона	р
ибн	о
ибо	о
ибодат	о
ибодатгоҳ	о
ибодатхона	о
иболи	с
ибора	о
иборат	ф,
ибосиз	с
ибрат	о
ибратли	с
ибратомуз	с
ибратхона	о
ибрий	о
иброний	о
ибтидо	о
ибтидоий	с
ивимоқ	ф
ивинди	о
ивирсиламоқ	ф
ивирсимоқ	ф
ивирсирамоқ	ф
ивирсиқ	с
ивир-шивир	т
ивитма	с
ивитмоқ	ф
ивитқи	о
ивишиқ	с
ивишмоқ	ф
ивиқ	о
иврит	о
иги-жиги	о
игир	о
игна	о
игнабарг	о
игнабарглилар	о
игнатерапия	о
игначи	о
игрек	о
игуана	о
ид	о
идбор	о
идда	о
иддао	о
идеал	о,с
идеализм	о
идеалист	о
идеалистик	с
идеаллаштирмоқ	ф
идентификация	о
идеограмма	о
идеографик	с
идеография	о
идеолог	о
идеологик	с
идеология	о
идея	о
идеявий	с
идиома	о
идиоматизм	о
идиоматик	с
идиоматика	о
идиш	о
идиш-оёқ	о
идиш-товоқ	о
идишқайтти	о
идо	о
идора	о
идоравий	с
идорачилик	о
идрамоқ	ф
идрок	о
идрокли	с
идроксиз	с
ие	у
иена	о
иероглиф	о
ижара	о
ижарадор	о
ижарахўр	о
ижарачи	о
ижикиламоқ	ф
ижирғаланмоқ	ф
ижирғанмоқ	ф
ижобат	о
ижобий	с
ижод	о
ижодбахш	с
ижодиёт	о
ижодий	с
ижодкор	о
ижодкорлик	о
ижодкорона	р
ижодхона	о
ижодчи	о
ижодчилик	о
ижозат	о
ижозатнома	о
ижозатсиз	р
ижро	о
ижроия	о
ижрочи	о
ижрочилик	о
ижтимоиёт	о
ижтимоий	с
ижтимоийлашмоқ	ф
ижтиноб	о
ижтиҳод	о
ижтиҳодли	с
из	о
иза	о
извош	о
извошчи	о
издиҳом	о
издош	о
изен	о
изза	о
иззат	о
иззат-икром	о
иззатламоқ	ф
иззатли	с
иззат-нафс	о
иззатталаб	с
изилламоқ	ф
излагич	о
изламоқ	ф
изланиш	о
изланмоқ	ф
изланувчан	с
изланувчи	о
изли	с
изловчи	о
изм	о
изма	о
изма-из	р
измаламоқ	ф
изн	о
изо	о
изо-	с
изобара	о
изолятор	о
изоляторчи	о
изоляцион	с
изоляция	о
изоляцияламоқ	ф
изомерия	о
изомерлар	о
изоморф	с
изоморфизм	о
изотермалар	о
изотермик	с
изотоплар	о
изофа	о
изофали	с
изохрон	с
изохронлик	о
изочизиқлар	о
изоҳ	о
изоҳламоқ	ф
изоҳли	с
изоҳловчи	о
изоҳот	о
изоҳотчи	о
изоҳталаб	с
изсиз	с
изтироб	о
изтиробли	с
изчи	о
изчил	с
изчиллик	о
изқувар	о
изғимоқ	ф
изғин	о
изғир	с
изғор	c
изғирин	о
изғиринли	с
изғириқ	о
изғирмоқ	ф
изҳор	о
ий	у
ийд	о
ийдлик	о
ийе	у
ийи	у
ийин	о
ийинди	о
ийир	о
ийиқ	о
ийламоқ	ф
ийманмоқ	ф
иймон	о
иймонсиз	с
иймоқ	ф
ийрим	о
ийсинмоқ	ф
ийя	у
ийқ	о
ийҳом	о
ик	о,т
икир-чикир	о
икки	сн
иккиёқлама	с
иккиламчи	р
иккиланмоқ	ф
иккилик	о
иккинчи	сн
иккинчидан	м
иккичи	о
иккиюзлама	с
иккиюзламалик	о
иккиюзламачи	с
иккиюзламачилик	о
иккиқат	с
иккиқатлик	о
икков	ол
икковлаб	р
икковлашиб	р
икковлон	ол
икковора	р
икона	о
икра	о
икром	о
икс	о
иксир	о
ила	б
илакишмоқ	ф
илалабад	р
иланг-биланг	с
илас-илас	р
илашимли	с
илашимлик	с
илашмоқ	ф
илвасин	о
илвирамоқ	ф
илвирс	о
илгак	о
илгакламоқ	ф
илгари	р,к
илгариги	c	
илгаригидай	р
илгаригидек	р
илгаригилар	о
илгаридан	р
илгариламоқ	ф
илгарилар	р
илгарилари	р
илгарилашмоқ	ф
илгаритдан	р
илгир	с
илгич	о
илдай	р,к
илдам	с,р
илдам-жилдам	с
илдамламоқ	ф
илдамлашмоқ	ф
илдамлик	о
илдиз	о
илдизламоқ	ф
илдизмева	о
илдизмевали	с
илдим-жилдим	с
илжаймоқ	ф
илжирамоқ	ф
илигузилди	о
илик	о
или-милиқ	с
илимоқ	ф
илинарли	с
илинж	о
илинмоқ	ф
илинчоқ	о
илиқ	с
илиқ-иссиқ	с
илиқлик	о
илиқ-милиқ	с
илиқмоқ	ф
илиғлик	о
илк	сн
илкис	р
илкисдан	р
илла	р
иллат	о
илло	б
илло-билло	р
иллюзионизм	о
иллюзия	о
иллюминатор	о
иллюминация	о
иллюстратив	с
иллюстратор	о
иллюстрация	о
илм	о
илма	о
илм-амал	о
илма-тешик	с
илмгоҳ	о
илмий	с
илмли	с
илмоқ	ф,о
илмоқдор	с
илмоқли	с
илмоқсиз	с
илмпарвар	о
илмсиз	с
илмсизлик	о
илова	о
иловали	с
илоё	у
илож	о
иложсиз	с
иложсизланмоқ	ф
иложсизлик	о
илойим	у
илон	о
илонбалиқ	о
илонбош	о
илоқ	о
илоҳ	о
илоҳа	о
илоҳи	у
илоҳиёт	о
илоҳий	с
илоҳийлаштирмоқ	ф
илоҳим	у
илоҳо	у
илтижо	о
илтижоли	с
илтимос	о
илтимоскорона	р
илтимоснома	о
илтимосчи	о
илтифот	о
илтифотли	с
илтифотсиз	с
илтифотсизлик	о
илғамоқ	ф
илғов	о
илғовли	с
илғор	о,с
илғорлик	о
илғоқсимоқ	ф
илҳақ	с
илҳом	о
илҳомбахш	с
илҳомланмоқ	ф
илҳомчи	о
им	о
им-дим	о
имдод	о
имзо	о
имзоламоқ	ф
имзосиз	с
ими-димида	р
ими-жимида	р
имилламоқ	ф
имирсиламоқ	ф
имкон	о
имконият	о
имконсиз	с
имламоқ	ф
имло	о
имловий	с
имманент	с
иммигрант	о
иммиграция	о
иммобилизация	о
иммунитет	о
иммунлаш	о
иммунология	о
имо	о
имо-ишора	о
имолашмоқ	ф
имоли	с
имом	о
имомат	о
имоматчилик	о
имомгарчилик	о
имомлик	о
имомча	о
имон	о
имонли	с
имонсиз	с
иморат	о
иморатсоз	о
иморатчи	о
имоқ	о
император	о
империализм	о
империалист	о
империалистик	с
империя	о
импичмент	о
импорт	о
импортёр	о
импотенция	о
импровизатор	о
импровизация	о
импульс	о
имранмоқ	ф
имсиз-димсиз	р
имтиёз	о
имтиёзли	с
имтиҳон	о
имтиҳонсиз	с
ин	о
инаугурация	о
инвалид	о
инвалидлик	о
инвентаризация	о
инвентарлаш	о
инвентарь	о
инверсия	о
инвестиция	о
инвестор	о
инг	т
инга	т
ингаламоқ	ф
ингалятор	о
ингаляция	о
ингилламоқ	ф
ингичка	с
ингичкаламоқ	ф
ингичкалашмоқ	ф
инглиз	о,с
инглизлар	о
инглизча	с,о
инграмоқ	ф
ингранмоқ	ф
ингроқ	о
индалло	о
индамас	ф
индамоқ	ф
индейс	с
индейслар	о
индекс	о
индексация	о
индивид	о
индивидуал	с
индивидуализм	о
индивидуалист	о
индивидуалистик	с
индивидуаллаштирмоқ	ф
индивидуаллик	о
индивидуум	о
индиго	о
индий	о
индикатор	о
индин	о,р
индинга	р
индинига	р
индов	о
индовчи	о
индонез	о,с
индонезлар	о
индуктив	с
индуктор	о
индукцион	с
индукция	о
индустриал	с
индустрия	о
индустриялаш	ф
индустрлаш	ф
индустриялашмоқ	ф
индустрлашмоқ	ф
инерт	о
инерция	о
инерцияли	с
инжа	с
инжалашмоқ	ф
инженер	о
инженерлик	о
инжил	о
инжимоқ	ф
инжирға	о
инжиқ	с
инжиқланмоқ	ф
инжиқлашмоқ	ф
инжиқлик	о
инжу	о
ини	о
инкассатор	о
инкассо	о
инквизитор	о
инквизиция	о
инкишоф	о
инкор	о,с
инкорпорация	о
инкубатор	о
инкубатория	о
инкубаторхона	о
инкубация	о
инкубист	о
инламоқ	ф
инлатмоқ	ф
инмоқ	ф
иннайкейин	р
иннана	о
инновация	о
инобат	о
инобатли	с
инобатсиз	с
инод	о
инон	о
инон-ихтиёр	о
инонмоқ	ф
иноят	о
иноятномоқ	ф
иноқ	р
иноқлашмоқ	ф
иноқлик	о
инс-жинс	о
инсон	о
инсонгарчилик	о
инсоний	с
инсонийлаштирмоқ	ф
инсонийлик	о
инсоният	о
инсонлик	о
инсонпарвар	о
инсонпарварлик	о
инсоф	о
инсофан	р
инсофли	с
инсофсиз	с
инсофсизлик	о
инспектор	о
инспекторлик	о
инспекция	о
инстарция	о
инстинкт	о
инстинктив	с
институт	о
инструктаж	о
инструктив	с
инструктор	о
инструкторлик	о
инструкция	о
инструментал	с
инсулин	о
инсульт	о
инсценировка	о
интеграл	о
интеграллаш	ф
интеграция	о
интеллект	о
интеллектуал	с
интеллигент	с
интеллигенция	о
интендант	о
интетсив	с,р
интенсивлаш	о
интер-	с
интерактив	с
интервал	о
интервент	о
интервенция	о
интервенциячи	о
интервидение	о
интервокал	с
интервью	о
интерлингва	о
интерлингвистика	о
интермедия	о
интернат	о
интернатура	о
интернационал	с
интернационализм	о
интернационалист	о
интернет	о
интернетлашув	о
интерпол	о
интерфаол	с
интерьер	о
интибоҳ	о
интизом	о
интизомий	с
интизомли	с
интизомсиз	с
интизомсизлик	о
интизор	с,о
интизорлик	о
интилиш	ф
интилма	с
интилмоқ	ф
интилувчан	с
интим	с
интихоб	о
интиқ	с
интиқмоқ	ф
интиқом	о
интиҳо	о
интиҳосиз	с
интоксикация	о
интонацион	с
интонация	о
интрига	о
интригачи	о
интуиция	о
инфаркт	о
инфекцион	с
инфекция	о
инфинитив	о
инфляция	о
информатика	о
информацион	с
информация	о
инфраструктура	о
инфратовушлар	о
инфратузилма	о
инфрақизил	с
инфузория	о
инчунин	б
иншо	о
иншоолло	у
иншооллоҳ	у
иншоот	о
инъекция	о
инъикос	о
инъом	о
инқиёд	о
инқилламоқ	ф
инқилоб	о
инқилобий	с
инқилобчи	о
инқироз	о
ион	о
иона	о
ионлашмоқ	ф
ионлашув	о
ионосфера	о
ип	о
ипак	о
ипакдай	с
ипакдек	с
ипакли	с
ипаклик	о
ипакфуруш	о
ипакчи	о
ипакчилик	о
ипилтириқ	с
ипир-ипир	с
ипириски	с
ипор	о
ипоргул	о
ипотека	о
ипподром	о
иприт	о
ипсиз	с
ирваймоқ	ф
иргамчик	с
ирганмоқ	ф
ирганч	с
иржаймоқ	ф
иридий	о
ирилламоқ	ф
ирим	о
иримига	р
иримкаш	о
иримоқ	ф
ирим-сирим	о
иримчи	о
ирим-чирим	о
ирин	о
ирит	о
ириш	о
иркилмоқ	ф
иркит	с
ирмоқ	о
ирод	о
ирода	о
иродали	с
иродасиз	с
иродасизлик	о
ирония	о
ироқ	с
ироқи	с
иррационал	о
ирригатор	о
ирригацион	с
ирригация	о
ирсий	с
ирсият	о
иршаймоқ	ф
иршод	о
ирқ	о
ирқий	с
ирқчи	о
ирқчилик	о
ирғай	о
ирғайзор	о
ирғалмоқ	ф
ирғамоқ	ф
ирғимоқ	ф
ирғитмоқ	ф
ирғишламоқ	ф
ис	о
исбот	о
исботламоқ	ф
исён	о
исёнкор	о,с
исёнкорлик	о
исёнкорона	р
исёнчи	о
исимоқ	ф
исинмоқ	ф
исириқ	о
исириқдон	о
исириқчи	о
исирға	о
иситкич	о
иситма	о
иситмаламоқ	ф
иситмалаш	ф
иситма-совутма	о
иситмоқ	ф
искабтопар	о
искамоқ	ф
искана	о
исканжа	о
искарт	о
исковуч	о,с
исламоқ	ф
исланмоқ	ф
исли	с
ислик	о
ислими	о
ислимий	о
ислиқи	с
исловот	о
исловотхона	о
исловотчи	о
ислом	о
исломий	с
исломия	с
исломият	о
ислоҳ	о
ислоҳот	о
исм	о
исмалоқ	о
исмат	о
исмдош	с
исмлалоқ	ф
исмли	с
иснод	о
испан	о,с
испанлар	о
испанча	с,о
испиҳон	о
исрор	о
исроф	о
исрофгар	о
исрофгарлик	о
исрофгарчилик	о
исрофламоқ	ф
исрофчи	о
исрофчилилик	о
иссиз	с
иссиқ	о,с
иссиқламоқ	ф
иссиқлик	о
иссиқсевар	с
иссиқ-совуқ	о
иссиқ-совуқчи	о
иссиқхона	о
истаган	ф
истак	о
истаклик	о
исталган	ф
исталмоқ	ф
истамоқ	ф
истара	о
истарали	с
истарапил	о
истар-истамас	р
истеъдод	о
истедодли	с
истеъмол	о
истеъмолчи	о
истеъмолчилик	о
истеъфо	о
истеҳзо	о
истеҳзоланмоқ	ф
истеҳзоли	с
истеҳзосиз	с
истеҳком	о
истибдод	о
истибдодчи	о
истило	о
истилочи	о
истилочилик	о
истилоҳ	о
истилоҳот	о
истинод	о
истинодгоҳ	о
истиора	о
истироҳат	о
истироҳатгоҳ	о
истисно	р
истисносиз	р
истисқо	о
истифода	о
истифодаланмоқ	ф
истифсор	о
истиқбол	о
истиқболли	с
истиқболсиз	с
истиқлол	о
истиқомат	о
истиқоматгоҳ	о
истиғно	о
истиғноли	с
истиғночи	о
истиғфор	о
истиҳола	о
исфаҳон	о
исфаҳоний	с
исчироқ	о
исқарлот	о
исқирт	с
исқот	о
исқоти	о
ит	о
италгу	о
итальян	о,с
итальянлар	о
итальянча	с,о
итармоқ	ф
итбалиқ	о
итбоз	о
итбурун	о
итвачча	о
итвой	о
итёқа	c
итирқин	c
итирқини	c
итлик	о
итмом	о
ит-мушук	о
итоат	о
итоатгўй	о
итоатгўйлик	о
итоаткор	о
итоаткорилик	о
итоаткорона	р
итоатли	с
итоатсиз	с
итоб	о
итобомуз	с
итолғи	о
итоғиз	о
итпашша	о
итсигек	о
иттербий	о
иттик	с
иттиканак	о
иттифоқ	о,с
иттифоқан	р
иттифоқдош	о
иттифоқлашмоқ	ф
иттифоқлик	о
иттифоқо	р
иттифоқчи	о
иттиҳод	о
иттрий	о
итузум	о
итфеъл	с
итчилик	о
итхона	о
итялоқ	о
итқитмоқ	ф
итқовун	о
ифлос	с
ифлосламоқ	ф
ифлослашмоқ	ф
ифлослик	о
ифо	о
ифода	о
ифодавий	с
ифодавийлик	о
ифодаламоқ	ф
ифодали	с
ифодалилик	о
ифодасиз	с
ифодачи	о
ифор	о
ифорли	с
ифрот	с
ифтиро	о
ифтихор	о
ифтихорли	с
ифтор	о
ифторлик	о
иффат	о
иффатли	с
иффатсиз	с
ифшо	о
ихват	о
ихлос	о
ихлосли	с
ихлосманд	с
ихрож	о
ихтиёр	о
ихтиёрий	с
ихтиёрийлик	о
ихтиёрли-ихтиёрсиз	с
ихтиёрсиз	с
ихтилол	о
ихтилолчи	о
ихтилот	о
ихтилоф	о
ихтилофли	с
ихтилофчи	о
ихтио-	с
ихтиозавр	о
ихтиол	о
ихтиолог	о
ихтиология	о
ихтиро	о
ихтирочи	о
ихтирочилик	о
ихтисос	о
ихтисослашмоқ	ф
ихтисосли	с
ихтисослик	о
ихчам	с
ихчамламоқ	ф
ихчамлашмоқ	ф
ихчамлик	о
ич	о
ичак	о
ичаклар	о
ичак-човоқ	о
ичағон	о
ич-бағир	о
ичбуруғ	о
ичгулик	о
ичдан	р
ичида	р,к
ичикиш	ф
ичикмоқ	ф
ичимли	с
ичимлик	о
ичин-ташин	с
ичишли	с
ичкари	о
ичкариламоқ	ф
ичкарилик	о
ичкетар	о
ички	с
ичкилик	о
ичкиликбоз	о
ичкиликбозлик	о
ичкиликхўр	о
ичкиликхўрлик	о
ички-ташқи	с
ичкуёв	о
ичкуяр	с
ичмоқ	ф
ичоғриқ	о
ичра	к
ичсуриш	о
ичтерлама	о
ичувчи	о
ичқотиш	о
ич-эт	о
иш	о
ишбай	о
ишбилармон	о
ишбилармонлик	о
ишбоп	с
ишбоши	о
ишбошқарувчи	о
ишбузуқи	о
ишва	о
ишвакор	с
ишвали	с
ишва-ноз	о
ишгир	с
ишёқмас	с
ишёқмаслик	о
ишкал	о
ишком	о
ишламоқ	ф
ишланма	о
ишлатмоқ	ф
ишли	с
ишлов	ф
ишонарли	с
ишонмоқ	ф
ишонувчан	с
ишонувчанлик	о
ишонч	о
ишончли	с
ишончсиз	с
ишончсизлик	о
ишонқирамоқ	ф
ишора	о
ишораламоқ	ф
ишорат	о
ишпеч	о
ишрат	о
ишратгоҳ	о
ишратпараст	о
ишратхона	о
ишсиз	о,р
ишсизлик	о
иштаҳа	о
иштаҳали	с
иштаҳасиз	с
иштаҳасизлик	о
иштибоҳ	о
иштиёқ	о
иштиёқли	с
иштиёқманд	с
иштиёқсиз	с
иштирок	о
иштирокиюн	о
иштирокчи	о
иштон	о
иштонбоғ	о
иштонсиз	о
иштончанг	р
ишхона	о
ишчан	с
ишчанлик	о
ишчи	о
ишш	у
ишшаймоқ	ф
ишюритиш	о
ишюритувчи	о
ишқ	о
ишқаламоқ	ф
ишқаланиш	о
ишқаланмоқ	ф
ишқамоқ	ф
ишқибоз	о
ишқибозлик	о
ишқий	с
ишқилиб	м
ишқирмоқ	ф
ишқор	о
ишқорий	с
ишқорламоқ	ф
ишқорли	с
ишғол	о
июль	о
июнь	о
ия	у
ияк	о
иярмоқ	ф
иқ	ф
иқбол	о
иқлим	о
иқлимий	с
иқлимлашмоқ	ф
иқлимшунослик	о
иқрор	о
иқтибос	о
иқтидо	о
иқтидор	о
иқтидорли	с
иқтидорсиз	с
иқтисод	о
иқтисодиёт	о
иқтисодий	с
иқтисодчи	о
иқто	о
иқтодор	о
иғво	о
иғвогар	о
иғвогарлик	о
иғвочи	о
иҳ	у
иҳонат	о
иҳота	о
иҳоталанмоқ	ф
иҳрамоқ	ф
иҳранмоқ	ф
иҳром	о
иҳтилом	о
