кабардин	о
кабардинлар	о
кабаре	о
кабелсоз	о
кабелсозлик	о
кабелчи	о
кабелчилик	о
кабель	о
каби	к
кабина	о
кабинет	о
кабир	с
кабиса	о
кабк	о
кабоб	о
кабобпаз	о
кабобпазлик	о
кабобхона	о
кабобхўр	о
кабобхўрлик	о
кабобчи	о
каботаж	о
кабутар	о
кавак	о
кавакламоқ	ф
кавалер	о
кавалерист	о
кавалерия	о
кавар	о
каверна	о
кавкаб	о
кавоб	о
кавобчи	о
каврак	о
кавсар	о
кавуш	о
кавушандоз	о
кавушдўз	о
кавушдўзлик	о
кавушчан	с,р
кавш	о
кавшамоқ	ф
кавшар	о
кавшарлагич	о
кавшарламоқ	ф
кавшовчи	ф
кагор	о
кадар	о
кадастр	о
кадет	о
кади	о
кадмий	о
кадр	о
кадхудо	о
каж	с
кажава	о
кажавали	с
кажбаҳс	с
кажбаҳслик	о
кажрав	с
кажрафтор	с
казак	о
казарма	о
казеин	о
каземат	о
каззоб	о
каззоблик	о
казино	о
казо-казо	о
кайвон	о
кайвони	о
кайман	о
кайманлар	о
кайнозой	о
кайф	о
кайфият	о
кайфланмоқ	ф
кайфли	с
кайф-сафо	о
кайфсиз	с
кайфсизланмоқ	ф
кайфчилик	о
кака	о
какао	о
какилламоқ	ф
какир-какир	т
какирламоқ	ф
какку	о
каклик	о
какра	о
кактус	о
кал	о
калава	о
калаваламоқ	ф
калавахона	о
калавачи	о
калака	о
каламенка	о
каламуш	о
калантар	о
калапатра	с
калвак	с
калварс	о
калдирамоқ	ф
календарь	о
калён	о
калжўрчи	о
калибр	о
калибрламоқ	ф
калибрли	с
калибрловчи	о
калид	о
калий	о
калийли	с
калима	о
калимагўй	о
калит	о
калитбон	о
калиш	о
калла	о
каллаварам	с,о
калладор	с
каллак	о
каллакдор	с
каллакесар	о
каллакламоқ	ф
каллапаз	о
каллапазлик	о
калла-поча	о
каллапўш	о
каллахом	о
каллхум	о
каллиграф	о
каллиграфия	о
каловаламоқ	ф
каловланмоқ	ф
калом	о
каломулло	о
калон	с
калондимоғ	с
калондимоғлик	о
калонпо	о
калориметр	о
калориметрия	о
калорифер	о
калория	о
калорияли	с
калориялилик	о
калта	с
калтабақай	с
калтабин	с
калтабинлик	о
калтадум	с
калтак	о
калтакесак	о
калтакзада	с
калтакламоқ	ф
калта-култа	с
калтатой	о
калтафаҳм	с
калтафаҳмлик	о
калтача	о
калхамаж	о
калхат	о
калька	о
калькаламоқ	ф
калькулятор	о
калькуляция	о
кальций	о
кам	сн,о
камаймоқ	ф
камалак	о
каманд	о
камар	о
камарбанд	с
камарбаста	о
камарбасталик	о
камаювчи	ф
камбала	о
камбар	с
камбарг	c
камбағал	с
камбағаллашмоқ	ф
камбағаллик	о
камбағалпарвар	с
камбағалчилик	о
камгак	о
камгап	с
камгўшт	с
камдаромад	с
камдийдор	с
камер	с
камера	о
камертон	о
камёб	с
камзул	о
ками	р
камида	р
камикадзе	о
камимоқ	ф
камин	о
камина	ол
кам-кам	р
кам-кетик	о
кам-кўст	о
камлик	о
каммаҳсул	с
камнамо	с
камоб	сн
камоблик	о
камол	о
камоли	р
камолот	о
камомад	о
камон	о
камонкаш	о
камонли	с
камонча	о
камончи	о
кампания	о
кампаниябозлик	о
кампаниячилик	о
кампир	о
кампирак	о
кампирдаҳан	с
кампирлик	о
кампирчопон	о
камситмоқ	ф
камсоқол	с
камсув	с
камсувлик	о
камсут	с
камсухан	с
камсуханлик	о
камсуқум	с
камсуқумлик	о
камтар	с
камтарин	с
камтаринлик	о
камтарлик	о
камтарона	р
камташвиш	с
камтик	о
камтуз	с
камфара	о
камфаросат	с
камфаҳм	с
камхаражат	с
камхарж	с
камхастак	о
камчил	с
камчилик	о
камчиликсиз	с
камчиллик	о
камчиқим	с
камшик	с
камқатнов	с
камқон	с
камқонлик	о
камқувват	с
камҳафсала	с
камҳафсалалик	о
камҳосил	с
кана	о
канакунжут	о
канал	о
канализация	о
каналчи	о
канарейка	о
канат	о
канахона	о
канва	о
канда	о
кандакор	о
кандакори	с
кандакорлик	о
кандидат	о
кандидатлик	о
кандидатура	о
кандик	о
кандил	о
кандир	о
кендир	о
каниз	о
канизак	о
каникул	о
канистр	о
канистра	о
канифоль	о
канна	о
каннибализм	о
канон	о
каноп	о
канопзор	о
канор	о
канора	о
каноэ	о
каноэчи	о
кантата	о
кантон	о
кантчи	о
кантчилик	о
канцелиярия	о
канцероген	о
канцлер	о
каолин	о
кап	о
капа	о
капаки	о
капалак	о
капгир	о
капелла	о
капельмейстер	о
капилляр	о
капитал	о
капитализация	о
капитализм	о
капиталист	о
капиталистик	с
капитан	о
капитуляция	о
капламоқ	ф
капот	о
каппа-каппа	т
каппалаб	р
каппон	о
каприччио	о
капрон	о
капсан	о
капсанчи	о
капсула	о
капсюль	о
капт	о
каптар	о
каптарбоз	о
каптархона	о
кар	с
карабин	о
карабинёр	о
каравот	о
карам	о
карамель	о
карамзор	о
карантин	о
карантинчи	о
караоке	о
карат	о
карате	о
каратэ	о
каратечи	о
карахт	с
карахтланмоқ	ф
карахтлик	о
караш	о
карашланмоқ	ф
канашма	о
карашмали	с
карбамид	о
карбид	о
карбол	о
карбонатлар	о
карборунд	о
карбос	о
карбункул	о
карбюратор	о
карвич	о
карвон	о
карвонбоши	о
карвонкаш	о
карвонсарой	о
карвонхона	о
кардинал	о
кардиограмма	о
кардиограф	о
кардиография	о
кардиолог	о
кардиология	о
карета	о
карж	о
каржламоқ	ф
каржли	с
кариес	о
карикатура	о
карикатурачи	о
карилламоқ	ф
карим	с,о
кариҳ	c
карк	о
каркас	о
карки	с
каркидон	о
карлик	о
кармак	о
кармон	о
карнавал	о
карнай	о
карнайгул	о
карнайчи	о
карниз	о
каромат	о
кароматли	с
кароматчи	о
каротин	о
карп	о
карра	к
каррали	с
карсиллама	с
карсилламоқ	ф
карс-карс	т
карт	с,о
карта	о
картабоз	о
картабозлик	о
карталаштирмоқ	ф
картель	о
картер	о
картечь	о
картина	о
картинг	о
картограмма	о
картограф	о
картография	о
картон	о
картотека	о
карточка	о
картошка	о
картошкагул	о
картошкакор	о
картошкачилик	о
картошкақовоқ	о
картриж	о
карусель	о
карч	о
карчламоқ	ф
карьер	о
карқулоқ	с
карқур	о
кас	о
касаба	о
касал	о,с
касалванд	с
касалланмоқ	ф
касаллик	о
касалманд	с
касалнамо	с
касалхона	о
касана	о
касаначи	о
касаначилик	о
касб	о
касбдош	о
касбий	с
касб-кор	о
касир-касир	т
касир-кусур	т
касирламоқ	ф
каска	о
каскад	о
каскадёр	о
каскадли	с
каскали	с
касод	о
касофат	с,о
касофатли	с
каср	о
касра	о
касратки	о
касрли	с
касса	о
кассация	о
кассета	о
кассир	о
кассирлик	о
каста	о
кастор	о
касторка	о
кастрюль	о
кастрюлька	о
кат	о
катайса	о
катак	о
катакча	о
каталак	о
катализ	о
катализатор	о
каталог	о
катапульта	о
катар	о
катаракта	о
катахреза	о
категория	о
категорияли	с
катер	о
катет	о
катетер	о
катмон	о
катод	о
католик	о
католцизм	о
каторга	о
катта	с
каттазанг	о
каттазанглик	о
каттаймоқ	ф
катта-кичик	с,о
каттакон	с
катталашмоқ	ф
катталик	о
каттармоқ	ф
каттақўрғон	о
катюша	о
каучук	о
кафан	о
кафангадо	с
кафанламоқ	ф
кафанлик	о
кафансиз	р
кафгир	о
кафе	о
кафедра	о
кафель	о
кафелли	с
кафил	о
кафиллик	о
кафолат	о
кафолатламоқ	ф
кафолатли	с
кафолатнома	о
кафорат	о
кафсан	о
кафт	о
кафтдек	с,р
кафтдай	с,р
кафш	о
кафшдўз	о
кахексия	о
качкил	о
кашак	о
кашал	с,о
кашалот	о
кашанда	о
кашандалик	о
кашар	о
кашкул	о
кашмир	с
кашмири	с
кашне	о
кашнич	о
кашол	с
кашта	о
каштадўз	о
каштадўзлик	о
каштали	с
каштан	о
каштачи	о
каштачилик	о
кашф	о
кашфиёт	о
кашфиётчи	о
кашшоф	о
каъба	о
каъбатулло	о
каъбатуллоҳ	о
каюта	о
кают-компания	о
каҳкашон	о
каҳрабо	о
квадрант	о
квадрат	о
квадратура	о
квадрат-уялаб	р
квалификация	о
квант	о
квартал	о
квартет	о
квартира	о
квартирант	о
кварц	о
кварцит	о
квас	о
квинта	о
квинтет	о
квитанция	о
кворум	о
квота	о
кебанак	о
кегай	о
кедр	о
кежим	о
кез	о
кезак	о
кезинмоқ	ф
кезмоқ	ф
кейин	р,к,б
кейинги	с
кейинча	р
кейинчалик	р
кейс	о
кек	о
кекирдак	о
кекирик	о
кекирмоқ	ф
кеккайма	с
кеккаймажон	с
кеккаймоқ	ф
кекли	с
кекс	о
кекса	с,о
кексаймоқ	ф	
кексалик	о
кексармоқ	ф
кекчи	с
келажак	с,о
келаси	с
келбат	о
келбатли	с
келгин	с
келгинди	с
келгуси	с
келди-кетди	о
кели	о
келиб-келиб	м
келим	о
келин	о
келинбарон	о
келинли	с
келинлик	о
келинкўрди	о
келинкўрар	о
келинойи	о
келинпошша	о
келинсалом	о
келинтушди	о
келинчак	о
келисоп	о
келича	о
келишган	ф,с
келишик	о
келишимли	с
келишмаган	ф
келишмовчилик	о
келишмоқ	ф
келиштирмоқ	ф
келишув	ф,о
келишувчилик	о
келмоқ	ф
келтирмоқ	ф
кема	о
кемакаш	о
кемасоз	о
кемасозлик	о
кемачи	о
кемик	о
кемирмоқ	ф
кемирувчи	ф
кемирувчилар	о
кемирчак	о
кемпинг	о
кемтик	о
кемтимоқ	ф
кемшик	с
кенас	о
кенг	с
кенгаймоқ	ф
кенгаш	о
кенгашли	с
кенгашмоқ	ф
кенгашчи	о
кенглик	о
кенг-ковул	с
кенгуру	о
кенгчилик	о
кендир	о
кенжа	с
кенжатой	о,с
кеннойи	о
кент	о
кепак	о
кепата	о
кепка	о
кепчик	о
керага	о
керагича	р
керак	м
керакли	с
кераксиз	с
керамзит	о
керамика	о
керги	о
керик	с
керилмажон	с
керилмачоқ	с
керилмоқ	ф
керишмоқ	ф
керкмоқ	ф
кермоқ	ф
керогаз	о
керосин	о
керосинка	о
кертик	о
кертмоқ	ф
кесак	о
кесаки	о
кесаклашмоқ	ф
кесатиқ	о
кесатмоқ	ф
кесик	с
кесим	о
кесишмоқ	ф
кескин	с
кескинлашмоқ	ф
кескинлик	о
кескир	с
кескич	о
кесма	о
кесмоқ	ф
кестирмоқ	ф
кет	о
кетворган	с
кетгут	о
кетма-кет	р
кетмон	о
кетмонламоқ	ф
кетмончи	о
кетмончилик	о
кетмоқ	ф
кетчуп	о
кефир	о
кеч	о
кеча	о,р
кечаги	с
кеча-кундуз	р
кечалик	с
кечаси	о,р
кечик	о
кечикмоқ	ф
кечинма	о
кечирим	о
кечиримли	с
кечирмоқ	ф
кечки	с
кечкирмоқ	ф
кечлатиб	р
кечлик	о
кечмиш	с,о
кечмоқ	ф
кечпишар	с
кечув	ф
кечқурун	р
кечқурунги	с
кибернетик	с
кибернетика	о
кибор	о
киборг	о
киборларча	р
киборлик	о
кибр	о
кибрланмоқ	ф
кибрли	с
кибрлик	о
кибр-ҳаво	о
кигиз	о
кизак	о
кий	о
кийик	о
кийикўт	о
кийим	о
кийим-бош	о
кийим-кечак	о
кийимли	с
кийимлик	с
кийинмоқ	ф
кийинтирмоқ	ф
киймоқ	ф
килкилламоқ	ф
кило	о
кило-	с
киловатт	о
киловатт-соат	о
килограмм	о
килограммли	с
километр	о
килотонна	о
ким	ол,б
кимарса	о
кимдир	ол
кимё	о
кимёвий	с
кимёгар	о
кимоно	о
кимса	о
кимсан	ол
кимсасиз	с
кимхоб	о
кин	о
кина	о
киндак	о
киндик	о
киндор	с
кинематограф	о
кинематографист	о
кинематография	о
кинематографчи	о
кинескоп	о
кинетик	с
кинетика	о
кинли	с
кинна	о
киннакаш	о
киннакашлик	о
кинналамоқ	ф
кинначи	о
кинначилик	о
кино	о
кино-	с
киноактёр	о
киноактриса	о
киноаппарат	о
киноаппаратура	о
киноартист	о
кинодраматургия	о
киножурнал	о
кинокартина	о
кинокомедия	о
киноконцерт	о
кинолаштирмоқ	ф
кинолента	о
кинолог	о
кинология	о
киномеханик	о
кинооператор	о
кинопанорама	о
киноплёнка	о
кинопрокат	о
кинорежиссёр	о
киностудия	о
киносценарий	о
кинотеатр	о
кинотехника	о
кинофестиваль	о
кинофильм	о
кинохроника	о
киночи	о
киношунос	о
киноя	о
кинояли	с
кинояомуз	р
киоска	о
киоскачи	о
кипратикан	о
киприк	о
кир	о,с
кира	о
киравериш	о
киравка	о
киракаш	о
киракашлик	о
кирдикор	о
кирди-чиқди	о
кирдор	о
кирза	о
кирим	о
кирим-чиқим	о
кириш	ф
киришимли	с
киришмоқ	ф
кирка	о
киркик	о
кирламоқ	ф
кирланмоқ	ф
кирмоқ	ф
кировка	о
киройи	с
киром	о
кирпеч	о
кирпи	о
кирпитикан	о
кирпўш	о
киртаймоқ	ф
кирт-кирт	т
кирточка	о
кирхона	о
кирчи	о
кир-чир	о
кирювди	о
кисель	о
кислород	о
кислота	о
кислотабардош	с
кислотали	с
кисса	о
киссавур	о
киссадўз	о
киста	о
кит	о
китель	о
китоб	о
китоба	о
китобат	о
китобдор	о
китобий	с
китобийлик	о
китобфуруш	о
китобхон	о
китобхона	о
китобхонлик	о
китобшунос	о
китобшунослик	о
кифоя	р
кифояланмоқ	ф
кифт	о
кичик	с
кичиклашмоқ	ф
кичиклик	о
кичири	о
кичкина	с
кичкинтой	с
кичраймоқ	ф
киш	у
кишан	о
кишанбанд	с
кишанламоқ	ф
кишанли	с
кишвар	о
киши	о
кишилашиб	р
кишилик	с
кишисиз	с
кишисизлик	о
киш-киш	у
кишкишламоқ	ф
кишмиш	о
кишнамоқ	ф
кишнов	о
кишт	у
кия	о
клавиатура	о
клавир	о
клавиш	о
клавишли	с
клапан	о
кларнет	о
кларнетчи	о
класс	о
классик	с
классика	о
классификация	о
классицизм	о
клеёнка	о
клемма	о
клерикал	с
клерикализм	о
клетчатка	о
клёш	о
клиент	о
клизма	о
климакс	о
климат	о
климатолог	о
климатология	о
климатотерапия	о
клиник	с
клиника	о
клинкер	о
клип	о
клиринг	о
клише	о
клон	о
клонлаш	ф
клонлаштириш	ф
клуб	о
ключ	о
кнопка	о
князлик	о
князь	о
коалицион	с
коалиция	о
кобальт	о
кобили	с
кобра	о
ковак	о
коваток	о
ковбой	о
ковбойка	о
коверкот	о
ковия	о
ковиялаш	о
ков-ков	о
ковлагич	о
ковламоқ	ф
ковлаштирмоқ	ф
ковул	о
ковуш	о
ковш	о
ковшли	с
код	о
кодекс	о
кодификация	о
кодлаш	ф
кодлаштириш	ф
кож	с
кожух	о
козёл	о
козир	о
козирёк	о
коинот	о
койимоқ	ф
койинмоқ	ф
койитмоқ	ф
койиш	ф
койка	о
койкали	с
койне	о
кокаин	о
кокетка	о
кокил	о
кокилдор	с
кокиль	о
кокос	о
кокс	о
коксламоқ	ф
коктейль	о
колба	о
колбаса	о
коленкор	о
колибри	о
колит	о
коллаж	о
коллегиал	с
коллегиаллик	о
коллегия	о
коллеж	о
коллектив	о
коллективизм	о
коллективлаштириш	ф
коллектор	о
коллекционер	о
коллекция	о
коллекциячи	о
коллизия	о
коллодий	о
коллоид	о
коллоквиум	о
колонист	о
колония	о
колонка	о
колонна	о
колонтитул	о
колонцифра	о
колорадо	о
колорит	о
колхоз	о
колхозлашмоқ	ф
колхозчи	о
колчедан	о
коляска	о
коляскали	с
ком	о
кома	о
команда	о
командир	о
командирлик	о
командировка	о
комбайн	о
комбайнчи	о
комбикорм	о
комбинат	о
комбинация	о
комбинезон	о
комедия	о
комендант	о
комендатура	о
комета	о
коми	о
комизм	о
комик	о,с
комил	с,о
коминтерн	о
комиссар	о
комиссариат	о
комиссарлик	о
комиссион	с
комиссионер	о
комиссия	о
комитент	о
комитет	о
комментарий	о
комментатор	о
коммерсант	о
коммерция	о
коммуна	о
коммунал	с
коммунар	о
коммунизм	о
коммуникатив	с
коммуникация	о
коммунист	о
коммунистик	с
коммутатор	о
коммутация	о
коммюнике	о
компакт-диск	о
компания	о
компаративизм	о
компас	о
компенсация	о
компетенция	о
компиляция	о
комплекс	о
комплект	о
композитор	о
композицион	с
композиция	о
компонент	о
компост	о
компостер	о
компостерламоқ	ф
компостламоқ	ф
компот	о
компресс	о
компрессор	о
компромисс	о
компьютер	о
компьютерлаштирмоқ	ф
комрон	с
комсомол	о
кон	о
конвейер	о
конвекция	о
конвенция	о
конверсия	о
конверт	о
конвертация	о
конвертер	о
конвоир	о
конвой	о
конгломерат	о,с
конгресс	о
конденсат	о
конденсатор	о
конденсация	о
кондитер	с
кондиция	о
кондиционер	о
кондуктор	о
кони	с
конка	о
конкрет	с
конкретлашмоқ	ф
конкуренция	о
конкурс	о
консалтинг	о
консенсус	о
консерва	о
консерваламоқ	ф
консерватив	с
консерватизм	о
консерватор	о
консерватория	о
консерваторлик	о
консервация	о
консервачи	о
консигнатор	о
консигнация	о
консилиум	о
консолидация	о
консонанс	о
консонантизм	о
консорциум	о
конспект	о
конспектив	с
конспиратив	с
конспиратор	о
конспирация	о
константа	о
конституцион	с
конституция	о
конституциявий	с
конструктив	с
конструктор	о
конструкция	о
консул	о
консуллик	о
консулхона	о
консультант	о
консультатив	с
консультация	о
контакт	о
контейнер	о
контекс	о
контингент	о
контингентлаштириш	о
континент	о
континентал	с
контора	о
контрабанда	о
контрабандист	о
контрабас	о
контрагент	о
контр-адмирал	о
контракт	о
контрактация	о
контрамарка	о
контраст	о
контратака	о
контрибуция	о
контролёр	о
контроль	о
контрреволюцион	о
контрреволюционер	о
контрреволюция	о
контузия	о
контур	о
контурли	с
конус	о
конфедерация	о
конферансье	о
конференц-зал	о
конференция	о
конфессия	о
конфет	о
конфискация	о
конфликт	о
конфронтация	о
конфуцийлик	о
конфуцийчилик	о
концентрат	о
концентратли	с
концентрацион	с
концентрация	о
концентрациялашмоқ	ф
концентрик	с
концепция	о
концерн	о
концерт	о
концертмейстер	о
концессия	о
концлагерь	о
кончи	о
кончилик	о
конь	о
коньки	о
конькичи	о
коньюнктива	о
коньюнктивит	о
коньюнктура	о
коньяк	о
кооператив	о
кооперативлашмоқ	ф
кооперативчи	о
кооператор	о
кооперация	о
кооптация	о
координат	о
координацион	с
координация	о
копар	с
копия	о
коптиков	о
копток	о
кор	о
коранда	о
корафта	с
коргоҳ	о
кордон	о
корейс	о,с
корейслар	о
коржома	о
корзинка	о
коридор	о
кориз	о
корламоқ	ф
коробка	о
короллик	о
король	о
коронка	о
корпоратив	с
корпорация	о
корпус	о
корректор	о
корректура	о
корреляция	о
корреспондент	о
корреспонденция	о
коррида	о
коррозия	о
коррупция	о
корсет	о
корсоз	о
корсон	о
корт	о
кортеж	о
корунд	о
корфармо	о
корхона	о
кохоначи	о
корчаллон	с
корчалон	с
корчаланлик	о
кор-ҳол	о
коса	о
косагул	о
косагуллик	о
косача	о
косачабарг	о
косеканс	о
косиб	о
косиблик	о
косибчилик	о
кослика	о
косинус	о
коски	о
косметик	с
косметика	о
косметолог	о
косметология	о
космик	с
космогоник	с
космогония	о
космодром	о
космонавт	о
космонавтика	о
космополит	о
космополитизм	о
космос	о
косов	о
костёл	о
костюм	о
костюмер	о
костюмлик	с
котангенс	о
котиб	о
котиба	о
котибият	о
котиблик	о
котировка	о
котлет	о
котлован	о
коттеж	о
кофе	о
кофеин	о
кофи	сн
кофир	о
кофта	о
кофтиков	о
кочегар	о
кочегарка	о
кошин	о
кошинкор	о,с
кошинкорлик	о
кошинли	с
кошинпаз	о
кошки	м
кошкийди	м
кошона	о
коэффициент	о
коҳин	о
коҳиш	о
краб	о
кран	о
кранчи	о
краска	о
кратер	о
крахмал	о
крахмалламоқ	ф
кредит	о
кредитор	о
крейсер	о
крекинг	о
крем	о
крематория	о
кремация	о
кремль	о
кремний	о
креоллар	о
креп	о
крепдешин	о
крепостник	о
крепостной	с
крепостнойлик	о
крепостнойчи	о
кресло	о
крест	о
крестгуллилар	о
криз	о
кризис	о
криминалист	о
криминалистик	с
криминалистика	о
криминология	о
криотерапия	о
криптограмма	о
криптография	о
криптон	о
кристалик	с
кристалл	о
кристалланмоқ	ф
кристаллизация	о
критерий	о
кровать	о
крона	о
кронштейн	о
кросс	о
кроссворд	о
крот	о
кружка	о
кружок	о
крузейро	о
крупа	о
ксенон	о
ксенофобия	о
ксерография	о
ксерокопия	о
ксерокс	о
ксилография	о
куб	о
кубанка	о
кубатура	о
кубизм	о
кубик	о
кубок	о
кубометр	о
кув	о
кува	о
куваламоқ	ф
куврак	с
кудунг	о
кудунггар	о
кудунгламоқ	ф
кудунгчи	о
кудурат	о
куёв	о
куёвбола	о
куёвлик	о
куёвнавкар	о
куз	о
кузак	о
кузамоқ	ф
кузатмоқ	ф
кузатилмоқ	ф
кузатиш	ф
кузатув	ф
кузатувчан	с
кузатувчанлик	о
кузатувчи	ф
кузги	с
кузир	о
кузлик	с
кузов	о
куй	о
куйди-пишди	о
куйдирги	о
куйиб-пишиб	р
куйиб-пишмоқ	ф
куйик	с
куйикмоқ	ф
куйинди	о
куйинмоқ	ф
куйинчак	с
куйинчаклик	о
куйит	о
куйиш	о
куйка	с
куйламоқ	ф
куймаланмоқ	ф
куйманмоқ	ф
куймоқ	ф
куйчи	о
ку-ку	т
кук-ку	т
куккуламоқ	ф
кукуламоқ	ф
кукун	о
кукунламоқ	ф
кул	о
кулала	о
куланкир	о
кулағон	с
кулба	о
кулги	о
кулгили	с
кулгилик	о
кулгич	о
кулдиргич	о
кулдон	о
кули	о
кулиш	ф
кул-кул	р
куллиёт	о
куллик	о
кулликламоқ	ф
кулликчи	о
кулмоқ	ф
кулол	о
кулоллик	о
кулолчилик	о
кулонғич	с
кулоҳ	о
култепа	о
кулумсимоқ	ф
кулумсирамоқ	ф
кулунч	с
кулфат	о
кулфатли	с
кулча	о
кулчатой	о
кульминацион	с
кульминация	о
культиватор	о
культивация	о
культуризм	о
кумуш	о
кумушланмоқ	ф
кумушсимон	с
кун	о
кунбай	с
кун-бакун	р
кунботар	о
кунботиш	о
кунгабоқар	о
кунгай	с
кунгура	о
кунгурадор	с
кунгурали	с
кунда	о,р
кундак	о
кундаков	о
кундал	о
кундалик	о,с
кундош	о
кундошлик	о
кундуз	о
кундузги	с
кундузи	р
кунж	о
кунжак	о
кунжара	о
кунжут	о
кунжутли	с
кунжутпоя	о
кунига	р
кунлашмоқ	ф
кунлик	с
кунора	р
кунпаякун	о
кунун	р
кунчи	о
кунчиламоқ	ф
кунчилик	о
кунчиқар	о
кунчиқиш	о
кунчувоқ	о
куня	о
купе	о
куплет	о
купон	о
купорос	о
курак	о
куракча	о
курамоқ	ф
курант	о
куратор	о
кураш	о
кураш	ф
курашмоқ	ф
курашчан	с
курашчи	о
курд	о
курдлар	о
курдик	о
курк	о
курка	о
куркунак	о
курмак	о
курорт	о
курортология	о
курра	о
курс	о
курсант	о
курсдош	о
курси	о
курсив	о
курсилламоқ	ф
курс-курс	т
курсовка	о
курт	с
куртак	о
куртакламоқ	ф
куртилламоқ	ф
куртка	о
курт-курт	т
курьер	о
кусамоқ	ф
кустар	о
кустари	с
кустарлик	о
кустарчилик	о
кутилмаган	ф,с
кутилмаганда	р
куткиламоқ	ф
кутмоқ	ф
кутубхона	о
кутубхоначи	о
куф	о
куфр	о
куфрланмоқ	ф
куфрлик	о
куфрон	о
куф-суф	о
куффор	о
куч	о
кучаймоқ	ф
кучала	о
кучан	о
кучанмоқ	ф
кучер	о
кучламоқ	ф
кучланмоқ	ф
кучланиш	о
кучланишли	с
кучли	с
кучлилик	о
кучсиз	с
кучсизланмоқ	ф
кучсизлик	о
кучук	о
кучукбачча	о
кушанда	о
кушетка	о
кушод	о
кушойиш	о
кушхона	о
куюк	о
куюнди	о
куюнмоқ	ф
куюнчак	с
куя	о
куҳ	т
куҳламоқ	ф
кьят	о
кюрий	о
кўган	о
кўганламоқ	ф
кўз	о
кўза	о
кўзанак	о
кўзбойлоғич	о
кўзбоғловчи	о
кўзбоғчи	о
кўзбўямачи	о
кўзбўямачилик	о
кўзгу	о
кўздай	с
кўзикмоқ	ф
кўз-кўз	о
кўзкўзламоқ	ф
кўзламоқ	ф
кўзли	с
кўзмунчоқ	о
кўзойнак	о
кўзойнакли	с
кўзсиз	с
кўз-қулоқ	о
кўй	о
кўйлак	о
кўйлакбоп	с
кўйлакли	с
кўйлаклик	о
кўйлакчан	р
кўк	о,с
кўка	о
кўкай	о
кўкалам	о
кўкаламзор	о
кўкаламзорлашмоқ	ф
кўканламоқ	ф
кўканак	о
кўкантой	о
кўкармоқ	ф
кўкат	о
кўкатзор	о
кўкимтир	с
кўкиш	с
кўкйўтал	о
кўклам	о
кўкламги	с
кўкламоқ	ф
кўкмараз	о
кўкнор	о
кокнори	о
кўкнорихона	о
кўкпоя	о
кўкрак	о
кўкракбурма	с
кўкракдор	с
кўкракли	с
кўкс	о
кўксов	с
кўксув	о
кўксултон	о
кўкча	о
кўкчи	о
кўкчил	с
кўкқарға	о
кўкқўтон	о
кўл	о
кўлага	о
кўлам	о
кўламдор	с
кўламли	с
кўланка	о
кўлбар	о
кўлбуқа	о
кўлвор	о
кўлик	о
кўлка	о
кўлламоқ	ф
кўллатмоқ	ф
кўлмак	о
кўлоб	о
кўлобламоқ	ф
кўлоблатмоқ	ф
кўма	о
кўмак	о
кўмакдош	с
кўмаклашмоқ	ф
кўмакчи	о
кўмач	о
кўмик	о
кўмилмоқ	ф
кўмир	о
кўмирланмоқ	ф
кўмирхона	о
кўмирчак	о
кўмирчи	о
кўмирчилик	о
кўмиш	ф
кўмма	о
кўммоқ	ф
кўмоч	о
кўн	о
кўнак	о
кўнгил	о
кўнгилламоқ	ф
кўнгиллашиб	р
кўнгилли	с,о
кўнгилочар	с
кўнгилсиз	с
кўнгилсизлик	о
кўнгилхушлик	о
кўнгилчан	с
кўнгилчанлик	о
кўндаланг	р
кўндалангига	р
кўндўзлик	о
кўникма	о
кўникмоқ	ф
кўнка	о
кўнмоқ	ф
кўнчи	о
кўнчилик	о
кўп	сн,р,о
кўпайиш	ф
кўпаймоқ	ф
кўпайтирмоқ	ф
кўпайтирувчи	о
кўпайтма	о
кўпас	о
кўпаювчи	о
кўпбурчак	о
кўпдан	р
кўпик	о
кўпикламоқ	ф
кўпикланмоқ	ф
кўпинча	р
кўпирмоқ	ф
кўпиртирмоқ	ф
кўпкари	о
кўпкаричи	о
кўпкураш	о
кўплаб	р
кўплар	о
кўплашмоқ	ф
кўплик	о
кўпмоқ	ф
кўппак	о
кўприк	о
кўптирма	о
кўптирмоқ	ф
кўпчик	о
кўпчилик	о
кўпчимоқ	ф
кўр	с
кўра	ф,к,о
кўрак	о
кўргазма	о
кўргазмали	с
кўргилик	о
кўрик	о
кўримли	с
кўримсиз	с
кўринарли	с
кўриниш	ф
кўринмоқ	ф
кўричак	о
кўриш	ф
кўришмоқ	ф
кўрк	о
кўркам	с
кўркамлашмоқ	ф
кўркамлик	о
кўркли	с
кўрксиз	с
кўр-кўрона	р
кўрларча	р
кўрлик	о
кўрмана	о
кўрмоқ	ф
кўрнамак	с
кўрнамаклик	о
кўройдин	о
кўролмаслик	о
кўрпа	о
кўрпалик	о
кўрпача	о
кўрсатиш	ф
кўрсаткич	о
кўрсатма	о
кўрсатмоқ	ф
кўрсатув	о
кўрсичқон	о
кўрфаз	о
кўршапалак	о
кўса	с
кўсак	о
кўсакламоқ	ф
кўсанамо	с
кўсов	о
кўст	о
кўтак	с
кўталанг	с
кўтара	с
кўтарам	с
кўтарасига	р
кўтарафуруш	о
кўтаргич	с
кўтарилмоқ	ф
кўтаринки	с
кўтаринкилик	о
кўтарма	с
кўтармалик	о
кўтармачи	о
кўтармоқ	ф
кўтоҳ	с
кўтоҳлик	о
кўч	о
кўча	о
кўча-кўй	о
кўчат	о
кўчатзор	о
кўчатхона	о
кўчатчилик	о
кўчим	о
кўчириқ	о
кўчирма	о,с
кўчиримакаш	о
кўчирмакашлик	о
кўчирмачи	о
кўчирмачилик	о
кўчирмоқ	ф
кўчки	о
кўчкин	о
кўчкинчи	с
кўч-кўлон	о
кўч-кўрон	о
кўчма	с
кўчманчи	о
кўчманчилик	о
кўчмоқ	ф
кўшак	о
кўшиш	о
кўшк	о
кўҳ	о
кўҳли	с
кўҳлик	с
кўхна	с
кўҳнармоқ	ф