чавандоз	о,с
чавандозлик	о
чавати	о
чавгон	о
чавкар	с,о
чавкон	о
чавоқ	о
чавоқламоқ	ф
чаён	о
чаёнвачча	о
чаёнўт	о
чайинди	о
чайир	с
чайирлик	о
чайла	о
чаймоқ	ф
чайналган	ф,с
чайналмоқ	ф
чайнам	о
чайнамоқ	ф
чайнворд	о
чайқалмоқ	ф
чайқалтирмоқ	ф
чайқамоқ	ф
чайқатмоқ	ф
чайқов	о
чайқовчи	о
чайқовчилик	о
чак	т
чакак	о
чакакли	с
чакак-чакак	с
чакалак	о
чакалакзор	о
чакамуғ	о
чакана	с
чаканалаб	р
чаканачи	о
чакана-чукана	с
чаканда	о
чакас	о
чакида	о
чакидахўр	о
чакилламоқ	ф
чакич	о
чакичламоқ	ф
чакка	о
чакказарб	с
чаккахона	о
чакки	с,о
чакки-чукки	с
чакма	о
чакмазак	о
чакмон	о
чакмоқ	ф
чакса	о
чакчак	о
чак-чак	т
чала	с,о
чалабош	с
чалабуталар	о
чалажон	с
чалакам-чатти	р
чалама-чатти	р
чаламулла	о,с
чаласавод	о
чаласаводлик	о
чала-чатти	р
чала-чулпа	р
чала-ярим	р
чалақурсоқ	с
чалдивор	о
чалинмоқ	ф
чалишмоқ	ф
чалишоёқ	с
чалиштирмоқ	ф
чалкаш	с
чалкашлик	о
чалкашмоқ	ф
чалкаштирмоқ	ф
чалкаш-чулкаш	с
чалма	о
чалмак	о
чалмашмоқ	ф
чалмақовоқ	о
чалмоқ	о
чалоб	о
чалов	о
чалп	т
чалпак	о
чалпимоқ	ф
чалп-чалп	т
чалп-чулп	т
чалчаймоқ	ф
чалчиқ	о
чалқа	т
чалқаймоқ	ф
чалқамча	р
чалқанча	р
чалқанчасига	р
чалқимоқ	ф
чалғи	о
чалғимоқ	ф
чалғит	с
чалғитмоқ	ф
чалғичи	о
чама	о,м
чамадон	о
чамаламоқ	ф
чамали	с
чаман	о
чамандагул	о
чаманзор	о
чамаси	р,м
чамасида	р
чамасидаги	р
чамбар	о
чамбарак	о
чамбарламоқ	ф
чамбарчас	р
чан	о
чана	о
чанг	о,с
чангак	о
чангал	о
чангалзор	о
чангалламоқ	ф
чангдон	о
чангимоқ	ф
чангитиш	ф
чангиткич	о
чангитмоқ	ф
чанглагич	о
чангламоқ	ф
чангланиш	о
чангланмоқ	ф
чангловчи	ф
чанговуз	о
чангсимон	с
чанг-тупроқ	о
чанг-тўзон	о
чангчи	о
чанг-чунг	о
чанг-ғубор	о
чандимоқ	ф
чандир	о
чандиш	ф
чандиқ	о,с
чандиқли	с
чандоза	о
чандон	р
чаноқ	о
чанқамоқ	ф
чанқатмоқ	ф
чанқов	ф
чанқовбосди	с
чанқоқ	с
чанқоқлик	о
чанғароқ	о
чанғи	о
чанғичи	о
чап	с,т
чапак	о
чапакбозлик	о
чапандоз	о
чапан	о
чапани	о
чапаниларча	р
чапанича	р
чапаничасига	р
чапанча	р
чапараста	р
чапати	о
чапақай	с
чапақайлик	о
чапдаст	с
чапдастлик	о
чапилламоқ	ф
чапиллатмоқ	ф
чапимоқ	ф
чапиштирмоқ	ф
чапиқ	о
чапламоқ	ф
чаплашмоқ	ф
чаппа	р
чаппар	о
чаппа-роста	р
чаппасига	р
чап-чап	т
чапчап	о
чапя	о
чапғалат	о
чарақламоқ	ф
чарақ-чарақ	т
чарви	о
чарвоқ	о
чарламоқ	ф
чарлар	о
чарм	о
чармламоқ	ф
чармфуруш	о
чарос	о
чароғ	о
чароғбон	о
чароғон	с
чарс	т
чарсилламоқ	ф
чарс-чарс	т
чарс-чурс	т
чартер	о
чарх	о
чархак	о
чархламоқ	ф
чархпалак	о
чархчи	о
чарчамоқ	ф
чарчоқ	о,с
чарчоқлик	о
часовой	о
частота	о
частотали	с
чатаноқ	о
чатилмоқ	ф
чатир	о
чатир-чутур	т
чатиш	ф
чатишмоқ	ф
чатиштириш	о
чатиштирмоқ	ф
чатиқ	с
чатма	о
чатмоқ	ф
чатнамоқ	ф
чатноқ	с
чатоқ	с
чатоқлашмоқ	ф
чатоқлик	о
чатоқ-чутоқ	с
чах-чах	т
чачвон	о
чашм	о
чашма	о
чашмбанд	о
чашначилик	о
чақа	о
чақалоқ	о
чақилмоқ	ф
чақимчи	о
чақимчилик	о
чақин	о
чақир	с
чақирилувчи	о
чақирим	о
чақиримламоқ	ф
чақириқ	о
чақирламоқ	ф
чақирмоқ	ф
чақиртикан	о
чақиртиканак	о
чақиртириқ	о
чақирув	о
чақич	о
чақишмоқ	ф
чақиқ	о
чақмачақар	о
чақмоқ	о
чақмоқдай	с
чақмоқдек	с
чақмоқи	о
чақмоқламоқ	ф
чақмоқтош	о
чақнамоқ	ф
чақноқ	с
чақноғич	о
чақув	о
чақча	о
чақчайма	с
чақчаймоқ	ф
чақчақ	о
чақчақламоқ	ф
чақчақлашмоқ	ф
чақчақлик	о
чақ-чуқ	т
чаққон	с,р
чаққонлашмоқ	ф
чаққонлик	о
чағалай	о
чағдавул	о
чангдовул	о
чағилламоқ	ф
чағир	о
чағирламоқ	ф
чағирлашмоқ	ф
чағир-чуғур	т
чағирқанот	о
чағрак	о
чағ-чағ	т
чағчағламоқ	ф
чағ-чуғ	т
чевар	о
чевара	о
чеваралик	о
чеврилмоқ	ф
чега	о
чеаламоқ	ф
чегана	с
чегара	о
чегарадош	с
чегараламоқ	ф
чегарали	с
чегарасиз	с
чегарачи	о
чегачи	о
чегирма	о
чегирмоқ	ф
чек	о
чека	о
чеканка	о
чеканачи	о
чеким	с
чекимлик	о
чекинди	о
чекиниш	ф
чекинмоқ	ф
чекист	о
чекиш	ф,о
чекка	о
чеккалик	с
чекламоқ	ф
чекланмоқ	ф
чекли	с
чекмоқ	ф
чексиз	с
чексизлик	о
чекчаймоқ	ф
чел	о
челак	о
челаклаб	р
челакчи	о
чемодан	о
чемпион	о
чемпионат	о
чен	о
чена	о
чеп	о
чер	о
червон	о
чердак	о
черепица	о
черёмуха	о
черик	о
черкас	о
черкаслар	о
черкез	о
черков	о
чертёж	о
чертиб-чертиб	р
чертмак	о
чертмоқ	ф
чет	о
четан	о
четки	с
четламоқ	ф
четланмоқ	ф
четлатмоқ	ф
четлашмоқ	ф
чех	о
чехлар	о
чеча	о
чечак	о
чечакламоқ	ф
чечан	с
чечанлашмоқ	ф
чечанлик	о
чечен	о
чеченлар	о
чечмоқ	ф
чеҳра	о
чибин	о
чибиқ	о,с
чибор	с
чивин	о
чивиқ	о,с
чигал	с
чигаллашмоқ	ф
чигаллик	о
чигил	о
чигиллар	о
чигиртка	о
чигит	о
чигитли	с
чидам	о
чидамли	с
чидамлилик	о
чидамоқ	ф
чидамсиз	с
чидаш	ф
чиёвламоқ	ф
чиёв-чиёв	т
чиён	о
чизги	о
чизеллаш	о
чизель	о
чизи	р
чизилишмоқ	ф
чизимча	о
чизиқ	о
чизиқли	с
чизма	о
чизмакаш	о
чизмакашлик	о
чизма-чизиқ	с
чизмачилик	о
чизмоқ	ф
чизғич	о
чий	о
чийбахмал	о
чийдухоба	о
чийилдоқ	с
чийилламоқ	ф
чийир	о
чийламоқ	ф
чийлампа	о
чийралмоқ	ф
чийрамоқ	ф
чийратма	с
чий-чий	т
чийчийламоқ	ф
чик	о
чикка	о
чикора	о
чил	о
чилангар	о
чилангарлик	о
чилбанд	с
чилвир	о
чилвирламоқ	ф
чилги	о
чилдирма	о
чилдирмакаш	о
чилдирмачи	о
чилёсин	о
чилим	о
чилимкаш	о
чилимқовоқ	о
чилла	о
чиллагузарон	о
чиллагуразон	о
чиллак	о
чиллакдай	с
чиллакдек	с
чиллаки	о,с
чиллакирўзон	о
чиллаксоп	о
чиллали	с
чиллашир	о,с
чиллик	о
чилон	о
чилонжийда	о
чилопчин	о
чилпарча	р
чилпарчин	р
чилпимоқ	ф
чилпора	р
чилп-чилп	т
чилтан	о
чилтор	о
чил-чил	р
чилчироқ	о
чилчўп	о
чим	о
чимдиламоқ	ф
чимдим	о
чимдимоқ	ф
чимзор	о
чимзорлик	о
чимилдиқ	о
чимирилмоқ	ф
чимирмоқ	ф
чимламоқ	ф
чиммат	о
чимтомоқ	с
чимхўр	с
чимчалоқ	о
чимчиламоқ	ф
чимчимоқ	ф
чимқирқар	о
чин	о,с
чинак	о
чинакам	с
чинакамига	р
чинакчи	о
чинакчилик	о
чинбарг	о
чингил	о
чинглинг	с
чиндан	р
чиндовул	о
чиний	с
чиниқмоқ	ф
чиниқтирмоқ	ф
чиниққанлик	о
чинк	о
чинг	о
чин-мочин	о
чинни	о,с
чиннигул	о
чиннидай	с
чиннидек	с
чиннисоз	о
чиннитарвуз	о
чиннитерак	о
чиннифуруш	о
чинничи	о
чиновник	о
чиноёқ	о
чинор	о
чиноқ	с
чиноқчи	о
чинчалоқ	о
чинқириқ	о
чинқирмоқ	ф
чинқироқ	о
чинғил	о
чинғилламоқ	ф
чинғирламоқ	ф
чип	т
чипор	с
чиппа	р
чиппак	о
чиппа-чин	р,с
чипта	о
чиптачи	о
чип-чип	т
чипқон	о
чир	р
чиранмачоқ	с
чиранмоқ	ф
чирги	о
чиргилик	о
чирик	с,о
чирилдоқ	с,о
чирилламоқ	ф
чиримоқ	ф
чиринди	о
чириш	о
чириқламоқ	ф
чирк	о,т
чиркин	с
чиркинлашмоқ	ф
чиркинлик	о
чирк-чирк	т
чирмалмоқ	ф
чирмамоқ	р
чирманда	о
чирмандакаш	о
чирмандачи	о
чирмашмоқ	ф
чирмашувчан	с
чирмов	ф
чирмовгул	о
чирмовуқ	о
чирой	о
чиройли	с,р
чиройсиз	с
чироқ	о
чироқпоя	о
чироқчи	о
чироғбон	о
чирпинди	о
чирпирак	о
чирпирамоқ	ф
чирпит	о
чирс	т
чирсиллама	с
чирсилламоқ	ф
чирс-чирс	т
чирт	т,р
чиртинг-пиртинг	с
чирт-пирт	т
чиртта	т
чирт-чирт	т
чир-чир	т
чирқ	т
чирқилламоқ	ф
чирқирамоқ	ф
чирқ-чирқ	т
число	о
чистон	о
чистончи	о
чит	о,с
читгар	о
читгарлик	о
читир	т
читирламоқ	ф
читир-читир	р
читмоқ	ф
читтак	о
читфуруш	о
читфурушлик	о
чих	у
чичангламоқ	ф
чия	о
чиябўри	о
чиқ	т
чиқавериш	о
чиқазмоқ	ф
чиқармоқ	ф
чиқаси	о
чиқилламоқ	ф
чиқим	о
чиқимдор	о
чиқимли	с
чиқинди	о
чиқир	т
чиқирламоқ	ф
чиқир-чиқир	т
чиқит	о
чиқиш	ф
чиқишмоқ	ф
чиқишоқ	с
чиқиқ	о,с
чиқмоқ	ф
чиқон	о
чиқ-чиқ	т
чиғ	т
чиғаноқ	о
чиғатой	о
чиғилламоқ	ф
чиғир	о
чиғириқ	о
чиғирламоқ	ф
чиғ-чиғ	т
чобуксувор	о
чов	о
човгум	о
човгун	о
човли	о
човут	о
чоган	о
чодир	о
чодиржамол	о
чодирхаёл	о
чодира	о
чодра	о
чой	о
чойгум	о
чойдиш	о
чойдон	о
чойжўш	о
чойкор	о
чойлашмоқ	ф
чойнак	о
чойпоя	о
чойфуруш	о
чойфурушлик	о
чойхона	о
чойхоначи	о
чойхўр	о
чойхўрлик	о
чойчақа	о
чойчўп	о
чойшаб	о
чок	о
чокар	о
чокламоқ	ф
чокчи	о
чокчилик	о
чок-чок	о
чол	о
чолвор	о
чол-кампир	о
чолғу	о
чолғули	с
чолғучи	о
чоп	о
чопар	о
чопағон	с
чопағонлик	о
чопишмоқ	ф
чопиқ	о
чопиқчи	о
чопмоқ	ф
чоповул	о
чопон	о
чопонфуруш	о
чоптирмоқ	ф
чоп-чоп	о
чопқи	о
чопқиламоқ	ф
чопқилламоқ	ф
чопқин	о
чопқир	с
чопқирлик	о
чор	сн,о
чора	о
чорабзал	о
чорак	сн
чоракор	о
чоракорлик	о
чоракта	сн
чорасиз	с
чорасизлик	о
чорасоз	о
чорбозор	о
чорбозорчи	о
чорбоғ	о
чорбурчак	о
чорва	о
чорвадор	о
чорвадорлик	о
чорвачи	о
чорвачилик	о
чорғоҳ	о
чордана	о
чордард	о
чордевор	о
чордоқ	о
чорёр	о
чорзарб	о
чори	о
чоризм	о
чорикор	о
чориқ	о
чоркунж	о
чоркўча	о
чорламоқ	ф
чорлов	о
чормих	о
чор-ночор	р
чоройна	о
чорпалак	о
чорпаҳил	с
чорпоя	о
чорраҳа	о
чорси	с,о
чорсу	с,о
чорсупа	о
чортанг	с
чортор	о
чортоқ	о
чорхари	c,о
чорчўп	о
чоршанба	о
чорқирра	с
чот	о
чотмоқ	ф
чоч	о
чочвоқ	о
чочиқ	о,с
чочмоқ	ф
чочоқ	о
чочоқбош	о
чочпопук	о
чочқи	о
чош	о,р
чошгоҳ	о
чошнигир	о
чош-чош	р
чоқ	о
чоқламоқ	ф
чоққина	с
чоғ	о,с
чоғи	м
чоғир	о
чоғиштирма	с
чоғиштирмоқ	ф
чоғламоқ	ф
чоғли	к
чоғлик	о
чоҳ	о
чу	у
чубур	о
чув	у,о
чувак	с,о
чуваланмоқ	ф
чувалашмоқ	ф
чувалмоқ	ф
чувалчанг	о
чувамоқ	ф
чуватмоқ	ф
чуваш	о
чувашлар	о
чуввос	о
чувимоқ	ф
чувламоқ	ф
чувоқ	с
чувринди	с
чувулламоқ	ф
чувур	о
чувурламоқ	ф
чувур-чувур	т,сн
чув-чув	т,сн
чуймоқ	ф
чук	о
чукбуррон	о
чукри	о
чукрон	о
чукурон	о
чулдирамоқ	ф
чилдиратмоқ	ф
чилдир-чулдир	т
чули-чули	с
чулки	о
чулон	о
чулчит	о
чулғамоқ	ф
чумак	о
чумоли	о
чумолича	р
чумчуқ	о
чумчуқкўз	о
чун	к
чунки	б
чунон	р
чунонам	р
чунончи	ол
чурвақа	о
чурр	т
чурра	о
чуррак	о
чурук	с
чурулламоқ	ф
чурқ	т
чучвара	о
чучварахона	о
чучимоқ	ф
чучитилмоқ	ф
чучкирмоқ	ф
чучмал	с
чучмаллашмоқ	ф
чучмўма	о
чучук	с
чучуклик	о
чучукмия	о
чучуктомоқ	о
чучут	о
чушкирмоқ	ф
чуқуламоқ	ф
чуқур	о,с,р
чуқурламоқ	ф
чуқурлашмоқ	ф
чуқурлик	о
чуқурча	о
чуғз	о
чуғулламоқ	ф
чуғур	о,т
чуғурламоқ	ф
чуғурлашмоқ	ф
чуғурчуқ	о
чуғур-чуғур	т
чуҳ	т
чуҳламоқ	ф
чўбир	о
чўгир	о
чўгири	о
чўгирма	о
чўзала	к
чўзилмоқ	ф
чўзилувчан	с
чўзилувчанлик	о
чўзинчоқ	с
чўзиқ	с
чўзиқлик	о
чўзма	о
чўзма-чалпак	о
чўзмоқ	ф
чўзғи	о
чўзғиламоқ	ф
чўк	т
чўкар	о
чўкарқанд	о
чўкик	с
чўкинди	о
чўкир	о
чўкирлик	о
чўкирмоқ	ф
чўкиртак	о
чўкич	о
чўкичламоқ	ф
чўк	т
чўкка	т
чўккаламоқ	ф
чўкма	о
чўкмоқ	ф
чўл	о
чўлистон	о
чўлиқ	о
чўлиқчи	о
чўлламоқ	ф
чўлланиш	о
чўллик	о
чўлоқ	с
чўлоқланмоқ	ф
чўлоқлик	о
чўлп	т
чўлпи	о
чўлпилламоқ	ф
чўлпон	о,с
чўлп-чўлп	т
чўлтоқ	с
чўлялпиз	о
чўлқувар	о
чўмилмоқ	ф
чўмич	о
чўмичламоқ	ф
чўммоқ	ф
чўнг	с
чўнтак	о
чўнқайма	о
чўнқаймоқ	ф
чўнқир	с
чўп	о
чўпиллатмоқ	ф
чўпон	о
чўпонлик	о
чўпон-чўлик	о
чўпса	о
чўпхина	о
чўпчак	о
чўпчакчи	о
чўри	о
чўрилик	о
чўрт	р
чўртан	о
чўрткесар	с
чўртта	р
чўт	о
чўтал	о
чўталчи	о
чўтир	с
чўтка	о
чўткаламоқ	ф
чўтламоқ	ф
чўх	сн
чўчангламоқ	ф
чўчимоқ	ф
чўччаймоқ	ф
чўчқа	о
чўчқабоқар	о
чўчқачилик	о
чўян	о
чўқиламоқ	ф
чўқим	сн
чўқимоқ	ф
чўқинди	о
чўқинмоқ	ф
чўқиштирмоқ	ф
чўқмор	о
чўққаймоқ	ф
чўққара	о
чўққи	о
чўғ	о
чўғланма	с
чўғланмоқ	ф
чўғол	с
