шаб	о
шабада	о
шабадаламоқ	ф
шабадалатмоқ	ф
шаббода	о
шабгард	о
шабдор	о
шабистон	о
шабихун	о
шабкўр	с
шабкўрлик	о
шаблон	о,с
шаблонлашмоқ	ф
шаблончилик	о
шабнам	о
шабнамланмоқ	ф
шабнамли	с
шабнамсиз	с
шабоҳанг	о
шабпарак	о
шабранг	с
шаброн	с
шаб-рўз	о
шабчироқ	о
шабчор	о
шавақи	с
шаввол	о
шавкат	о
шавкатли	с
шавла	о
шавқ	о
шавқланмоқ	ф
шавқли	с
шавқсиз	с
шавҳар	о
шагрень	о
шаддод	с
шаддодлик	о
шажара	о
шай	о
шайба	о
шайдо	о
шайдойи	о
шайдойилик	о
шайдолик	о
шайин	о
шайка	о
шайламоқ	ф
шайтанат	о
шайтон	о
шайтонбачча	о
шайтоний	с
шайтонковуш	о
шайтонкоса	о
шайтонламоқ	ф
шайтонлик	о
шайтонтери	о
шайх	о
шайхлик	о
шайхулислом	о
шак	о
шакар	о
шакарак	о
шакарангур	о
шакаргуфтор	о,с
шакаргуфторлик	о
шакарламоқ	ф
шакарли	с
шакарнай	о
шакароб	о
шакарпаз	о
шакарпазлик	о
шакарпалак	о
шакарпоя	о
шакарқамиш	о
шаккок	о
шаккоклик	о
шакл	о
шаклан	р
шакланмоқ	ф
шаклдор	с
шаклий	с,р
шаклик	о
шаклланмоқ	ф
шаклли	с
шакл-шамойил	о
шаксиз	р
шал	с,о
шалаббо	с
шалайим	с
шалваймоқ	ф
шалвар	о
шалвилламоқ	ф
шалвираган	ф
шалвирамоқ	ф
шалдирама	с
шалдирамоқ	ф
шалдироқ	с
шалдир-шулдур	т
шалдир-шулдурлик	о
шаллақи	с
шаллақиларча	р
шаллақилик	о
шалола	о
шалоп	т
шалопламоқ	ф
шалоқ	с
шалоқлик	о
шалп	т
шалпаймоқ	ф
шалпанг	с
шалпангқулоқ	с
шалтоқ	о
шалтоқхона	о
шалҳак	о
шам	о
шама	о
шамалоқ	с
шамалоқдай	с
шамалоқдек	с
шаман	о
шамгарлик	о
шамгин	с
шамдон	о
шамиён	о
шамли	с
шамойил	о
шамол	о
шамолламоқ	ф
шамоллатмоқ	ф
шамоллаш	ф
шамолли	с
шамолпаррак	о
шамолсиз	с
шампан	о
шампанский	о
шампунь	о
шамс	о
шамса	о
шамсия	о
шамчироқ	о
шамшир	о,с
шамшод	о
шамғалат	с
шанба	о
шанбалик	о
шантаж	о
шантажчи	о
шанғи	с
шанғилламоқ	ф
шанғимоқ	ф
шап	т
шапалоқ	о
шапалоқгул	о
шапалоқламоқ	ф
шапарак	с
шапати	о
шапатиламоқ	ф
шапилламоқ	ф
шапир-шупур	т
шапка	о
шапкали	с
шапоқ	о
шаппа	р
шаппаламоқ	ф
шаппати	о
шаппатиламоқ	ф
шапшак	с
шапшаклик	о
шап-шуп	т
шар	о,т
шара-бара	о
шараф	о
шарафа	о
шарафламоқ	ф
шарафли	с
шарақ	т
шарақламоқ	ф
шарақ-шарақ	т
шарақ-шуруқ	т
шарбат	о
шарбатдор	с
шарж	о
шариат	о
шариатпаноҳ	о
шарик	о
шарикли	с
шариллаб	р
шарилламоқ	ф
шариллатмоқ	ф
шариф	ю
шарлатан	с
шарм	о
шарманда	о
шармандагарчилик	о
шармандали	с
шармандалик	о
шармандачилик	о
шармисор	о
шармисорлик	о
шармли	с
шармсиз	с
шарнир	о
шарнирли	с
шароб	о
шаробхона	о
шаробхўр	с,о
шаробхўрлик	о
шаробчи	о
шароит	о
шарора	о
шарорат	о
шарофат	о
шарофатли	с
шарофатсиз	с
шарпа	о
шарпасиз	р,с
шарр	о
шаррос	р,о,с
шарт	о,т,р
шартак	о
шартаки	с,о
шартакилик	о
шартилламоқ	ф
шарткесар	с
шартлашмоқ	ф
шартли	с,р
шартнома	о
шартсиз	с,р
шартта	р
шарттаки	с,о
шарт-шурт	р
шарф	о
шаршара	о
шаршарак	о
шаръан	р
шаръий	с
шарқ	о
шарқий	с
шарқирамоқ	ф
шарқироқ	р
шарқлик	о
шарқона	с
шарқча	с
шарқшунос	о
шарқшунослик	о
шарҳ	о
шарҳламоқ	ф
шасси	о
шатак	о
шатакламоқ	ф
шатакчи	о
шаталоқ	о
шаталоқламоқ	ф
шатилламоқ	ф
шатир	т
шатира-шутур	т
шатирламоқ	ф
шатирлатмоқ	ф
шатир-шутур	т
шатмоқ	с
шатранж	о
шатта	о
шатталамоқ	ф
шафақ	о
шафақланмоқ	ф
шафе	о
шафиқ	с
шафоат	о
шафтоли	о
шафтолизор	о
шафтолихўр	о
шафтолиқоқи	о
шаффоф	с
шафқат	о
шафқатли	с
шафқатсиз	с
шафқатсизлик	о
шаҳдам	р
шахмат	о
шахматчи	о
шахс	о
шахсан	р
шахсий	с
шахсия	с
шахсият	о
шахсиятпараст	о
шахсиятпарастлик	о
шахт	о,р
шахта	о
шахтачи	о
шахтёр	о
шахтёрлик	о
шаша	с
шашвар	о
шашка	о
шашкачи	о
шашлик	о
шашмақом	о
шашапар	о
шашт	о
шашқатор	с
шашқол	о
шаъбон	о
шаън	о
шақ	т
шақал	о
шақатул	с
шақашулдур	с
шақилдоқ	о
шақилламоқ	ф
шақирламоқ	ф
шақир-шуқур	т
шақшақ	о
шақшақадор	с
шақ-шуқ	о
шағал	о,сн
шағилламоқ	ф
шаҳ	о
шаҳаншоҳ	о
шаҳар	о
шаҳарлашмоқ	ф
шаҳарлик	о
шаҳарнамо	о
шаҳарсоз	о
шаҳарча	р,о
шаҳарчилик	о
шаҳбоз	о
шаҳват	о
шаҳватпараст	о
шаҳвоний	с
шаҳд	о
шаҳд-шакар	с
шаҳзода	о
шаҳид	о
шаҳло	с,о
шаҳноз	о
шаҳодат	о
шаҳодатнома	о
шаҳр	о
шаҳристон	о
шаҳсувор	о
швед	о,с
шведлар	о
швейцар	о
шева	о
шевиот	о
шевро	о
шезлонг	о
шейпинг	о
шекел	о
шекил	м
шекилли	м
шелуха	о
шер	о
шерандом	о
шербачча	о
шеренга	о
шерзод	о
шерик	о
шериклашмоқ	ф
шериклик	о
шерикчилик	о
шерланмоқ	ф
шерозий	с
шеролғин	о
шерсть	о
шестерня	о
шеф	о
шефлик	о
шеф-повар	о
шеър	о
шеърий	с
шеърият	о
шеърхонлик	о
шеършунослик	о
шиа	о
шиалик	о
шибба	о
шиббаламоқ	ф
шиваламоқ	ф
шиваға	о
шивилламоқ	ф
шивилғони	о
шивир	т
шивирламоқ	ф
шивирғони	о
шивит	о
шиддат	о
шиддаткор	с
шиддатланмоқ	ф
шиддатли	с
шижоат	о
шижоаткор	с
шижоаткорона	с
шижоатли	с
шижоатсиз	с
шизофрения	о
шиий	о
шиийлар	о
шийдам	c
шийпон	о
шикаст	о
шикаста	с
шикастламоқ	ф
шикастланмоқ	ф
шикастсиз	с
шиква	о
шиквали	с
шикор	о
шикоят	о
шикоятбоз	о
шикоятбозлик	о
шикоятланмоқ	ф
шикоятли	с
шикоятнамо	р,с
шикоятнома	о
шикоятомуз	р,с
шукоятчи	о
шил	с
шилвирамоқ	ф
шилдир	т,с
шилдирама	с	
шилдирамоқ	ф
шилдироқ	с
шилимшиқ	с
шилингпоча	с
шилинмоқ	ф
шилиқ	о
шиллинг	о
шиллиқ	о,с
шилмоқ	ф
шилп	т
шилпилдоқ	о
шилпиқ	о
шилпиқланмоқ	ф
шилт	т
шилта	с,о
шилтилламоқ	ф
шилқ	т
шилқилламоқ	ф
шилқим	о
шилқимларча	р
шилқимлик	о
шилққа	т,р
шим	о
шимариқ	с
шимариғлиқ	с
шимармоқ	ф
шимимоқ	ф
шимирмоқ	ф
шиммоқ	ф
шимол	о
шимолий	с
шимоли-шарқ	о
шимоли-шарқий	с
шимоли-ғарб	о
шимоли-ғарбий	с
шимоллик	о
шимпанзе	о
шина	о
шинаванда	о,с
шинак	о
шиналаш	ф
шинам	с
шингарф	о
шингил	о
шингилламоқ	ф
шингил-шапоқ	о
шинель	о
шинни	о
шинғилламоқ	ф
шинғирламоқ	ф
шинғраймоқ	ф
шиор	о
шип	о,т
шипилдоқ	с
шипилламоқ	ф
шипирги	о
шипирламоқ	ф
шипирмоқ	ф
шиппак	о
шиптир	о
шипши	о
шипшийдам	с
шипшимоқ	ф
шипшитмоқ	ф
шир	т,о
шира	о
ширава	о
ширавор	о
шираворпаз	о
шираворпазлик	о
шираворчи	о
ширадор	с
ширадорлик	о
ширакайф	с
ширали	с
ширалик	о
ширапаз	о
ширапазлик	о
ширасиз	с
ширач	о
ширачламоқ	ф
ширбоз	с
ширвоз	с
ширгуруч	о
ширдон	о
ширзада	о
ширилламоқ	ф
ширин	с
ширинак	о
шириндимоғ	с
ширинкома	о
ширинламоқ	ф
ширинлик	о
ширинмия	о
ширинсухан	с
ширинсўз	с
ширинсўзлик	о
ширинтак	о
ширинтой	о
ширинтомоқ	с
ширинча	о
ширин-шакар	с,о
шириқ	т
шириқламоқ	ф
ширк	о
ширкат	о
ширма	о
ширмой	о
ширмойи	о
ширмон	о
широлға	о
ширт	т
ширхўра	о
ширхўрда	о
ширчой	о
ширқ	т
ширқилламоқ	ф
ширқирамоқ	ф
ширқовоқ	о
шитир	т
шитирламоқ	ф
шитоб	о,р
шифер	о
шифо	о
шифобахш	с
шифобахшлик	о
шифокор	о
шифоламоқ	ф
шифоли	с
шифолик	о
шифон	о
шифоньер	о
шифосиз	с
шифохона	о
шифочи	о
шифр	о
шифрламоқ	ф
шифт	о
шиханг	о
шихангламоқ	ф
шихта	о
шиш	о
шиша	о
шишадам	о
шишадош	о
шишак	о
шишасоз	о
шишинмоқ	ф
шиширмоқ	ф
шишмоқ	ф
шиқ	т
шиқилдоқ	о
шиқилламоқ	ф
шиқиллатмоқ	ф
шиқир	т
шиқирламоқ	ф
шиғ	т
шиға	р
шиғаб	р
шиғаламоқ	ф
шиғил	р
шиғилламоқ	ф
шиғирламоқ	ф
шиғовул	о
шиғраймоқ	ф
шкала	о
шкаф	ф
шкив	о
шлагбаум	о
шлак	о
шлакобетон	о
шлакоблок	о
шланг	о
шланга	о
шлем	о
шлемофон	о
шлифовка	о
шлифовкачи	о
шлюз	о
шлюпка	о
шляпа	о
шмуцтитул	о
шницель	о
шнур	о
шобир	о
шов	т
шовва	о
шоввоз	с
шовдирамоқ	ф
шовинизм	о
шовинист	о
шовинистик	с
шовул	о,сн
шовулдек	сн
шовулдай	сн
шовулламоқ	ф
шовун	о
шовур	т
шовур-шувур	т
шовуш	о
шовшамоқ	ф
шов-шув	т
шов-шувли	с
шов-шувсиз	с
шовқин	о
шовқинламоқ	ф	
шовқинли	с
шовқин-сурон	о
шовқин-суронли	с
шовқинчи	о
шогирд	о
шогирдлик	о
шод	с
шода	о
шодаламоқ	ф
шоди	о
шодиёна	о,с
шодимарг	о
шодланмоқ	ф
шодлик	о
шодмон	с,о
шодмонлик	о
шодон	с
шодонлик	о
шоён	с
шоир	о
шоира	о
шоирлик	о
шоирона	о
шойи	о
шойибоф	о
шойигул	о
шойифуруш	о
шок	о
шокила	о
шокиладор	с
шокилали	с
шокилда	о
шоколад	о
шоколадли	с
шокоса	о
шол	о,с
шоли	о
шоликор	о,с
шоликорлик	о
шолипоя	о
шоличилик	о
шопар	с
шолча	о
шол-шол	о
шолғом	о
шом	о
шомон	о
шомонлик	о
шомпол	о
шомполли	с
шомруқ	о
шомурт	о
шон	о
шона	о
шонабарг	о
шоналамоқ	ф
шонли	с
шоп	о
шопиринмоқ	ф
шопирмоқ	ф
шоп-шалоп	о
шоссе	о
шосупа	о
шотерак	о
шоти	о
шотикапа	с
шотир	о
шотланд	о,с
шотландка	о
шотландлар	о
шотут	о
шоу	о
шоу-бизнес	о
шофёр	о
шох	о
шохалак	о
шохариқ	о
шохилак	о
шохламоқ	ф
шахли	с
шохобча	о
шохсиз	с
шох-шабба	о
шоша-пиша	р
шошиб-пишиб	р
шошилинч	с,р,о
шошилиш	о
шошилмоқ	ф
шошма	ф
шошманг	ф
шошма-шошар	с
шошма-шошарлик	о
шошмоқ	ф
шошқалоқ	с
шошқалоқламоқ	ф
шошқалоқлик	о
шошқин	с
шошқинлик	о
шошқоқ	с
шояд	м
шоядки	о
шоқул	о
шоҳ	о
шоҳаншоҳ	о
шоҳбайт	о
шоҳи	о
шоҳид	о
шоҳидлик	о
шоҳичи	о
шоҳлик	о
шоҳнишин	о
шоҳнома	о
шоҳона	с
шоҳроҳ	о
шоҳсупа	о
шоҳтут	о
шпаклёвка	о
шпатлёвка	о
шпал	о
шпанка	о
шпаргалка	о
шпат	о
шпатель	о
шпилька	о
шпинделли	с
шпиндель	о
шпион	о
шпионлик	о
шпонка	о
шпор	о
шпора	о
шпорли	с
шприц	о
шрифт	о
штаб	о
штаб-квартира	о
штамп	о
штампламоқ	ф
штамповка	о
штамповкачи	о
штанга	о
штангачи	о
штангенциркуль	о
штапель	о
штат	о
штатив	о
штатсиз	с
штемпель	о
штик	о
шторм	о
штраф	о
штрейкбрехер	о
штрих	о
штурвал	о
штурвалчи	о
штурм	о
штурман	о
штурмбозлик	о
штурмовик	о
штурмчи	о
штурмчилик	о
шу	ол
шуаро	о
шуба	о
шубҳа	о
шубҳаланмоқ	ф
шубҳали	с
шубҳасиз	с,м
шубҳачи	о
шув	т
шувалмоқ	ф
шувамоқ	ф
шувоқ	о
шувоқзор	о
шувоқчи	о
шувулламоқ	ф
шувут	с
шуд	о
шудгор	о
шудгорламоқ	ф
шудли	с
шудринг	о
шудсиз	с
шуйтиб	т
шук	о
шукр	у
шукрона	о
шукроналик	о
шукур	у
шукуҳ	о
шукуҳли	с
шул	ол
шулон	о
шулха	о
шум	с
шумлик	о
шумоёқ	о
шумтака	о
шумтол	о
шумурт	о
шумшаймоқ	ф
шумшук	с
шумшуклик	о
шумқадам	о
шумғия	о
шунақа	ол,р
шунақанги	ол,р
шунақаси	ол,р
шунг	о
шундай	ол,р
шундайин	ол
шундайича	р
шундайлигича	р
шундоқ	ол,р
шунингдек	с,м
шунча	р,ол
шунчайики	р,с
шунчайин	р,с
шунчаки	р,с
шунчалик	р
шунқор	о
шуруп	о
шуру	о
шуруъ	о
шурф	о
шуур	о
шуурий	с
шуурли	с
шуурсиз	с
шуурсизлик	о
шу-шу	р
шуъба	о
шуъла	о
шуълаланмоқ	ф
шуғулланмоқ	ф
шуҳрат	о
шуҳратламоқ	ф
шуҳратли	с
шуҳратпараст	о
шуҳратпарастлик	о
шчи	о
шчит	о
шўлп	т
шўлти-шўрва	о
шўлқ	т
шўлқилламоқ	ф
шўнғимоқ	ф
шўп	т
шўппаймоқ	ф
шўр	с,о
шўра	о
шўражриқ	о
шўразор	о
шўрак	о
шўраламоқ	ф
шўрва	о
шўрва-шўлти	о
шўрданак	о
шўрида	о
шўрийда	о
шўриш	о
шўришли	с
шўрламоқ	ф
шўрланмоқ	ф
шўрли	с
шўрлик	о,с
шўро	о
шўрпешона	о
шўртак	с
шўртанг	с
шўртоб	о
шўртумшуқ	о
шўртупроқ	с
шўрхок	с
шўх	с
шўхлик	о
шўхчан	с
шўх-шатир	с
