э	у,ю
эб	о
эв	о
эваз	о
эвакуация	о
эвара	о
эвен	о
эвенк	о
эвенклар	о
эвенлар	о
эвида	о
эвкалипт	о
эвламоқ	ф
эволюцион	с
эволюция	о
эвоҳ	у
эврилмоқ	ф
эвтаназия	о
эвфемизм	о
эвфония	о
эга	о
эгали	с
эгалик	о
эгалламоқ	ф
эгар	о
эгарламоқ	ф
эгарланмоқ	ф
эгарлоғлиқ	с
эгарсимон	с
эгарчи	о
эгарчилик	о
эгасиз	с
эгасизлик	о
эгат	о
эгачи	о
эгиз	о
эгизак	о
эгик	с
эгилик	о
эгилма	с
эгилмоқ	ф
эгилувчан	с
эгилувчанлик	о
эгин	о
эгин-бош	о
эгма	с
эгмоқ	ф
эгов	о
эговламоқ	ф
эговланмоқ	ф
эгоизм	о
эгоист	о
эгоистик	с
эгоистлик	о
эгоцентризм	о
эгри	с
эгри-бугри	с
эгрилик	о
эди	ф
эдикиламоқ	ф
эзгин	с
эзгинлик	о
эзгу	с
эзгулик	о
эзибички	о
эзик	с
эзилишмоқ	ф
эзилмоқ	ф
эзма	с
эзмаланмоқ	ф
эзмалашмоқ	ф
эзмалик	о
эзма-чурук	с
эзмоқ	ф
эзғиламоқ	ф
эй	у,ю
эйвоҳ	у
эйнштейний	о
эйфория	о
экан	ф
экватор	о
экваториал	о,с
эквивалент	о,с
экзема	о
экземпляр	о
экзотика	о
экин	о
экинзор	о
экинли	с
экин-текин	о
экинчи	о
экинчилик	о
экипаж	о
эклектизм	о
эклектик	о,с
эклиптика	о
экма	с
экмоқ	ф
экологик	с
экология	о
экономизм	о
экономика	о
экономист	о
экономия	о
экран	о
экранламоқ	ф
экранлаштирмоқ	ф
экранли	с
экс-	с
эксгумация	о
экскаватор	о
экскаваторчи	о
экскурс	о
экскурсант	о
экскурсия	о
экскурсиячи	о
экскурсовод	о
экспансионист	о
экспансионистик	с
экспансия	о
экспансиячи	о
экспедитор	о
экспедиторлик	о
экспедицион	с
экспедиция	о
экспедициячи	о
эксперимент	о
экспериментал	с
экспериментчи	о
эксперт	о
экспертиза	о
эксплуататор	о
эксплуатация	о
эксплуатациячи	о
экспозиция	о
экспонат	о
экспонометр	о
экспорт	о
экспресс	о
экспромт	о
экспроприатор	о
экспроприация	о
экстаз	о
экстерн	о
экстернат	о
экстерриториал	с
экстерриториаллик	о
экстра	с
экстрадиция	о
экстракт	о
экстрактив	с
экстракция	о
экстрасенс	о
экстремизм	о
экстремист	о
экстремистик	с
экувли	с
экувсиз	с
эл	о
элак	о
элакишмоқ	ф
элакчи	о
элак-элак	о
эламоқ	ф
эланмоқ	ф
элан-қаран	р
элас	р
эласлаб	р
эластик	о,с
элас-элас	р
элат	о
элатдош	о
элатлик	о
элатчилик	о
элашимли	с
элбеги	о
элбурундан	р
элбурутдан	р
элдош	о
элеватор	о
электр	о,с
электрик	о,с
электрификация	о
электричка	о
электрламоқ	ф
электрлаштириш	ф
электрли	с
электр-	с
электро-	с
электровоз	о
электрод	о
электродинамик	с
электродинамика	о
электрокардиограмма	о
электрокардиограф	о
электрокардиография	о
электрокимё	о
электролиз	о
электролит	о
электролитик	с
электромагнит	о
электрометр	о
электрометрия	о
электромеханик	о,с
электромеханика	о
электромонтёр	о
электромотор	о
электрон	о,с
электроника	о
электронли	с
электропайванд	о
электрпайванд	о
электропайвандчи	о
электрпайвандчи	о
электроскоп	о
электростанция	о
электростатик	с
электростатика	о
электротерапия	о
электротехник	о,с
электротехника	о
электрчи	о
элемент	о
элементар	с
элик	 о
эликишмоқ	ф
эликмоқ	ф
элимоқ	ф
элит	с
элита	о
элитмоқ	ф
элламоқ	ф
эллик	сн,с
элликбоши	о	
эллипс	о
эллипсис	о
эллипсоид	о
эллиптик	с
элнавкар	о
эловламоқ	ф
эловсиз	с
эловсирамоқ	ф
эломон	о
элпарвар	о
элсевар	с
элтмоқ	ф
элфуруш	о
элчи	о
элчилик	о
элчихона	о
эм	о
эмакдош	о
эмакламоқ	ф
эмаль	о
эман	о
эманзор	о
эмансипация	о
эмас	ф
эмбарго	о
эмблема	о
эмбриолог	о
эмбриологик	с
эмбриология	о
эмбрион	о
эмгак	о
эмгакламоқ	ф
эмгакчи	о
эмди	р
эмигрант	о
эмиграция	о
эми-дими	о
эмизак	о
эмизгич	о
эмизик	о
эмизикли	с
эмикдош	о
эмин	с
эмин-эркин	р
эмиссион	с
эмиссия	о
эмиш	ф
эмламоқ	ф
эммоқ	ф
эмоционал	с
эмоционаллик	о
эмоция	о
эмпиризм	о
эмпирик	о,с
эмпириокритик	о
эмпириокритицизм	о
эмранмоқ	ф
эмульсия	о
эмфаза	о
эмфизема	о
эмчак	о
эмчакдош	о
эмчи	о
эн	о
эна	о
энага	о
энамоқ	ф
энағар	о
энг	с
энгак	о
энгашмоқ	ф
энгил	о
энгил-бош	о
энди	р,ю
эндиги	с
эндиликда	р
эндокринолог	о
эндокринология	о
эндоскопия	о
эндшпиль	о
энеолит	о
энергетик	о,с
энергетика	о
энергия	о
энергоблок	о
эниш	ф
энкаймоқ	ф
энка-тенка	о
энка-тинка	о
энламоқ	ф
энли	с
энлик	с,о
энмоқ	ф
энса	о
энсақотар	с
энсиз	с
энтак-тентак	с
энтикмоқ	ф
энтомолог	о
энтомология	о
энцефалит	о
энцефалограмма	о
энциклопедик	с
энциклопедист	о
энциклопедия	о
энциклопедиячи	о
энчи	о
эп	о
эпашанг	с
эпақа	о
эпақали	с
эпиграмма	о
эпиграф	о
эпиграфика	о
эпидемик	с
эпидемиолог	о
эпидемиологик	с
эпидемиология	о
эпидемия	о
эпизод	о
эпизодлик	с
эпизоотия	о
эпик	с
эпикриз	о
эпилепсия	о
эпилог	о
эпителиал	с
эпителий	о
эпитет	о
эпицентр	о
эпкин	о
эплама	с
эпламоқ	ф
эплаштирмоқ	ф
эпли	с
эпопея	о
эпос	о
эпоха	о
эпсиз	с
эпсизлик	о
эпчил	с
эпчиллик	о
эр	о
эра	о
эрам	о
эран-қаран	р
эрбий	о
эрганак	о
эргаш	о
эргашиш	ф
эргашмоқ	ф
эрдонча	о
эримоқ	ф
эринмоқ	ф
эринчак	с
эринчаклик	о
эринчоқ	о
эриткич	о
эритма	о
эритроцитлар	о
эритувчи	ф
эриш	ф
эришмоқ	р
эрк	о
эрка	с
эркак	о
эркакламоқ	ф
эркаклашмоқ	ф
эркаклик	о
эркакча	р
эркакчалиш	с,р
эркакчилик	о
эркакшода	о
эркакўт	о
эркаламоқ	ф
эркалик	о
эркан	ф
эркатой	с
эркин	с,о
эркинлик	о
эркли	с
эркпарвар	с
эрксевар	с
эрксиз	с
эрксизлик	о
эрли	с
эрлик	о
эрмак	о
эрмакламоқ	ф
эрмакталаб	о
эрмакчи	о
эрман	о
эрмана	о
эрмиш	ф
эрмоқ	ф
эровул	о
эрозия	о
эроний	с
эронлик	о
эронликлар	о
эроншунос	о
эроншунослик	о
эррайим	о
эррайимлик	о
эрса	б
эрсиз	с
эрсирамоқ	ф
эрта	р,о
эртага	р
эртаги	с
эртак	о
эртакчи	о
эрталаб	о
эрталабки	с
эрталик	о
эртаматан	р
эрта-мертан	р
эртан	о
эртанги	с
эрув	ф
эрувгарчилик	о
эрувчан	с
эрувчилик	о
эрудиция	о
эрур	ф
эс	о
эса	б
эсаймоқ	ф
эсанкирамоқ	ф
эсар	о
эсвос	о
эсдалик	о
эсиз	у,м
эсирик	с
эсирикмоқ	ф
эсирмоқ	ф
эскадра	о
эскадрилья	о
эскадрон	о
эскалатор	о
эскалация	о
эскармоқ	ф
эскартиш	ф
эскартма	о
эскартмоқ	ф
эски	с
эскидан	р
эскидўз	о
эскиз	о
эскилик	о
эскимо	о
эскимос	о
эскимослар	о
эскимоқ	ф
эскирмоқ	ф
эски-туски	с
эскифуруш	о
эскича	с,р
эскичасига	р
эскичи	о
эскудо	о
эсламоқ	ф
эслатма	о
эслатмоқ	ф
эсли	с
эсли-хушли	с
эсминец	о
эсмоқ	ф
эснамоқ	ф
эснаш	ф
эсноқ	о
эсон	р
эсонлашмоқ	ф
эсонлик	о
эсон-омон	р
эсончилик	о
эспандер	о
эсперанто	о
эссе	о
эссенция	о
эссиз	с
эстакада	о
эстафета	о
эстафетачи	о
эстет	о
эстетизм	о
эстетик	с
эстетика	о
эстон	о,с
эстонлар	о
эстонча	с,о
эстрада	о
эсхона	о
эс-эс	р
эс-ҳуш	о
эт	о
этаж	о
этажерка	о
этажли	с
этак	о
этакли	с
этаксиз	с
эталон	о
этан	о
этап	о
этдор	с
этик	о
этика	о
этикдўз	о
этикет	о
этикетка	о
этикчи	о
этимологик	с
этимология	о
этиология	о
этли	с
этмоқ	ф
этник	с
этногенез	о
этнограф	о
этнографик	с
этнография	о
этноним	о
этнос	о
этсиз	с
этхўр	о
этюд	о
эфемер	о
эфемерлар	о
эфир	о
эфирли	с
эффект	о
эффектив	с
эффектли	с
эхинококк	о
эхинококкоз	о
эчкемар	о
эчки	о
эчкичи	о
эчкичилик	о
эчкиэмар	о
эш	о
эшак	о
эашквой	о
эшакем	о
эшакеми	о
эшакмия	о
эшакқурт	о
эшвой	о
эшдош	с
эшелон	о
эшик	о
эшилмоқ	ф
эшитиш	ф
эшитмоқ	ф
эшиттириш	ф
эшитувчи	ф
эшкак	о
эшкакли	с
эшкакчи	о
эшкил-кишан	о
эшлик	о
эшма	с
эшмоқ	ф
эшон	о
эшонзода	о
эшонойим	о
эшонпараст	о
эъзоз	о
эъзозламоқ	ф
эъзозли	с
эълон	о
эълоннома	о
эътибор	о
эътиборан	р
эътиборли	с
эътиборсиз	с
эътиборсизлик	о
эътидол	о
эътимод	о
эътимодли	с
эътимоднома	о
эътироз	о
эътирозланмоқ	ф
эътирозсиз	с
эътироф	о
эътиқод	о
эътиқодли	с
эътиқодсиз	с
эътиқодсизлик	о
эҳ	у
эҳа	у
эҳе	у
эҳзон	о
эҳром	о
эҳсон	о
эҳсонли	с
эҳтидо	о
эҳтиёж	о
эҳтиёт	о
эҳтиётдан	р
эҳтиёткор	с
эҳтиёткорлик	о
эҳтиёткорона	р
эҳтиётламоқ	ф
эҳтиётлик	о
эҳтиётсиз	с
эҳтиётсизлик	о
эҳтиётчан	с
эҳтимол	о,м
эҳтимолки	м
эҳтиром	о
эҳтирос	о
эҳтиросли	с
эҳтироссиз	с