ғаввос	о
ғавғо	о
ғавғоли	с
ғавғосиз	с
ғавғочи	о
ғадаб	о
ғадабламоқ	ф
ғадаблов	о
ғаданг	р
ғаддор	о
ғаддорлик	о
ғадир	с
ғадир-будур	с
ғажиламоқ	ф
ғажимоқ	ф
ғажир	о,т
ғажирламоқ	ф
ғажир-ғужур	т
ғаза	о
ғазаб	о
ғазабдор	о,р
ғазабкор	с,р
ғазабламоқ	ф
ғазабланмоқ	ф
ғазабли	с
ғазабнок	с
ғазал	о
ғазалгўй	о
ғазалиёт	о
ғазалнавис	о
ғазалнавислик	о
ғазалхон	о
ғазалхонлик	о
ғазалчилик	о
ғазна	о
ғазначи	о
ғазноқ	о
ғазо	о
ғазовот	о
ғазол	о
ғазот	о
ғайб	о
ғайир	с
ғайирланмоқ	ф
ғайирлик	о
ғайноли	о
ғайр	о
ғайрат	о
ғайратланмоқ	ф
ғайратли	с
ғайратсиз	с
ғайри	с
ғайри-	с
ғайриадабий	с
ғайриахлоқий	с
ғайрибадиий	с
ғайридин	о
ғайридиний	с
ғайрижинс	о
ғайриилмий	с	
ғайриинсоний	с
ғайриихтийрий	с
ғайримашру	с
ғайрирасмий	с
ғайритабиий	с
ғайришаръий	с
ғайришуурий	с
ғайриқонуний	с
ғалаба	о
ғаладон	о
ғаладонли	с
ғалаён	о
ғалаёнли	с
ғалаёнчи	о
ғаламис	о
ғаламислик	о
ғалат	о
ғалати	с
ғалатсиз	с
ғала-ғовур	о
ғалва	о
ғалваймоқ	ф
ғалвали	с
ғалвасиз	с
ғалвахона	о
ғалвачи	о
ғалвир	о
ғалвирак	с
ғалвирчи	о
ғалдирамоқ	ф
ғализ	с
ғализлик	о
ғалла	о
ғалладон	о
ғаллазор	о
ғаллакор	о
ғаллакорлик	о
ғалласимон	с
ғаллахона	о
ғаллачилик	о
ғалт	т
ғалтак	о
ғалтакарава	о
ғалтакмола	о
ғалча	о
ғам	о
ғамбода	с
ғамгин	с
ғамгинлик	о
ғамгузор	о
ғамдош	о
ғамза	о
ғамзада	о
ғамзали	с
ғамкаш	о
ғамламоқ	ф
ғамли	с
ғаммоз	о
ғаммозлик	о
ғамнок	с
ғамсиз	с
ғамхона	о
ғамхўр	с
ғамхўрлик	о
ғана	о
ғани	с
ғаним	о
ғанимат	о
ғанимлик	о
ғар	о
ғараз	о
ғаразгўй	о
ғаразгўйлик	о
ғаразли	с
ғаразсиз	с
ғаразчи	о
ғарам	о
ғарамлагич	о
ғарамламоқ	ф
ғарб	о
ғарб-жанубий	с
ғарбий	с
ғарби-шимолий	с
ғарвачча	о
ғариб	о
ғарибланмоқ	ф
ғариблашмоқ	ф
ғариблик	о
ғарибон	о
ғарибона	с
ғарибпарвар	о
ғарибуддиёр	о
ғариб-ғурабо	о
ғарлик	о
ғаров	о
ғаройиб	с
ғаройибот	о
ғарра-шарра	р
ғарт	т
ғартилламоқ	ф
ғарт-ғурт	т
ғарч	т
ғарчиллама	с
ғарчилламоқ	ф
ғарчли	с
ғарчсиз	с
ғарчча	р
ғарч-ғурч	т
ғарқ	ф,р
ғарқоб	о
ғарғара	т,о
ғарғаша	ф
ғасб	ф
ғассол	о
ғат	т
ғатилламоқ	ф
ғафлат	о
ғачча	р
ғаш	с,о
ғашава	о
ғашламоқ	ф
ғашланмоқ	ф
ғашлик	о
ғашғаша	о
ғаюр	с
ғақ	т
ғақилламоқ	ф
ғақ-ғуқ	т
ғағилламоқ	ф
ғивак	с
ғавилламоқ	ф
ғавирламоқ	ф
ғивирсимоқ	ф
ғивир-шивир	т
ғивир-ғивир	т
ғиди-биди	т
ғидиллашмоқ	ф
ғидингламоқ	ф
ғиди-ғиди	т
ғидо	о
ғидғидламоқ	ф
ғид-ғидок	т
ғижбанг	т
ғажбангламоқ	ф
ғажжак	о
ғижжакчи	о
ғижилламоқ	ф
ғижиллашмоқ	ф
ғижим	с,о
ғижимламоқ	ф
ғижин	о
ғижинмоқ	ф
ғижир	т
ғижирламоқ	ф
ғижирлашмоқ	ф
ғижмалоқ	с
ғижмалоқламоқ	ф
ғиж-ғиж	т
ғиз	т
ғизилламоқ	ф
ғизо	о
ғизол	о
ғизғизак	о
ғийбат	о
ғийбатхона	о
ғийбатчи	о
ғийт	т
ғийтилламоқ	ф
ғийч	т
ғийқ	т
ғийқилламоқ	ф
ғилай	с
ғилайланмоқ	ф
ғилайлашмоқ	ф
ғилайлик	о
ғилдирак	о
ғилдиракли	с
ғилдираксоз	о
ғилдираксозлик	о
ғилдиракча	о
ғилдирамоқ	ф
ғилдирламоқ	ф
ғилмон	о
ғилоф	о
ғилофламоқ	ф
ғилофли	с
ғилофчи	о
ғилт	т
ғилтилламоқ	ф
ғилқ	т
ғилқилламоқ	ф
ғимилламоқ	ф
ғимирламоқ	ф
ғимирсиламоқ	ф
ғимирсимоқ	ф
ғимирчиламоқ	ф
ғимир-ғимир	т
ғинг	т
ғингилламоқ	ф
ғингшимоқ	ф
ғиншимоқ	ф
ғинғилламоқ	ф
ғинғирламоқ	ф
ғинғир-ғинғир	т
ғинғ-ғинғ	т
ғип	т
ғиппа	т
ғир	т
ғира-шира	о
ғирваймоқ	ф
ғирилламоқ	ф
ғиринг	т
ғирингламоқ	ф
ғиринг-пиринг	т
ғиринг-ғиринг	т
ғирмаймоқ	ф
ғирра	р
ғирром	о
ғирромлик	о
ғирромчилик	о
ғирт	с,т
ғиртилламоқ	ф
ғирч	т
ғирчиллама	с
ғирчилламоқ	ф
ғирчча	с
ғир-ғир	т
ғирғирак	о
ғирғираки	о
ғит	т
ғитилламоқ	ф
ғичилламоқ	ф
ғичир	т
ғичирламоқ	ф
ғич-ғич	т
ғиша	о
ғишава	о
ғишавачи	о
ғишазор	о
ғишт	о
ғиштин	с
ғиштли	с
ғиштчи	о
ғишғиша	о
ғиқ	т
ғиқилламоқ	ф
ғов	о
ғовак	о
ғовламоқ	ф
ғовур	о
ғовурлашмоқ	ф
ғовуш	о
ғовға	о
ғоз	о
ғоза	о
ғозий	о
ғозкаптар	о
ғозланмоқ	ф
ғозоёқ	о
ғозпанжа	о
ғозяпроқ	о
ғоз-ғоз	т
ғойиб	ф
ғойибдан	р
ғойибона	р
ғолиб	с
ғолибият	о
ғолибкор	о
ғолиблик	о
ғолибо	м
ғолибона	р
ғон	о
ғор	о
ғорат	о
ғоратгар	о
ғоратчи	о
ғофил	с
ғофиллик	о
ғоя	о
ғоявий	с
ғоявийлик	о
ғояли	с
ғоясиз	с
ғоят	с
ғоятда	с
ғубор	о
ғуборланмоқ	ф
ғуборли	с
ғуборсиз	с
ғув	т
ғувва	р
ғуввос	с
ғувулламоқ	ф
ғувур	о
ғувурламоқ	ф
ғув-ғув	т
ғувғувламоқ	ф
ғудда	о
ғудранмоқ	ф
ғудраша	с
ғудулламоқ	ф
ғудунгламоқ	ф
ғудур	с
ғудурламоқ	ф
ғуж	с
ғужанак	с
ғужилламоқ	ф
ғужламоқ	ф
ғужмаймоқ	ф
ғужмак	с
ғужум	о
ғужумламоқ	ф
ғужур	т
ғужурламоқ	ф
ғужғон	о
ғул	о
ғулдирамоқ	ф
ғулом	о
ғуломгардиш	о
ғулт	т
ғулу	о
ғулув	о
ғулғула	о
ғулғулали	с
ғулғуласиз	с
ғумай	о
ғумбак	о
ғунажин	о
ғунда	о
ғунча	о
ғунчаламоқф
ғунчачи	о
ғуппа	о
ғуппак	с
ғурбат	о
ғурбатсаро	о
ғурбатхона	о
ғурилламоқ	ф
ғурмушламоқ	ф
ғурра	о
ғуррак	о
ғуруб	о
ғурур	о
ғурурланмоқ	ф
ғурурли	с
ғурурлик	о
ғурурона	р
ғурғурак	о
ғурғурамоқ	ф
ғус	у
ғусл	о
ғуслхона	о
ғусса	о
ғуссали	с
ғуссасиз	с
ғусул	о
ғусғусламоқ	ф
ғуч	с
ғўдайган	ф
ғўдаймоқ	ф
ғўдилламоқ	ф
ғўдир	с
ғўдранмоқ	ф
ғўза	о
ғўзапоя	о
ғўзапўчоқ	о
ғўзафуруш	о
ғўзачаноқ	о
ғўла	о
ғўлабур	с
ғўлак	ф
ғўлдилламоқ	ф
ғўлдирамоқ	ф
ғўлдирламоқ	ф
ғўлдир-ғўлдир	т
ғўнг	т
ғўнон	о
ғўнғилламоқ	ф
ғўнғирламоқ	ф
ғўнғир-ғўнғир	т
ғўр	с
ғўра	о
ғўраламоқ	ф
ғўралик	о
ғўраша	с
ғўрилламоқ	ф
ғўрлик	о
ғўр-шўр	с
ғўтилламоқ	ф
ғўт-ғўт	т
ғўч	с
