қабаринқи	с
қабариқ	с
қабармоқ	ф
қабарчимоқ	ф
қабз	о
қабза	о
қабзият	о
қабзиятланмоқ	ф
қабзланмоқ	ф
қабил	к
қабила	о
қабилавий	с
қабиладош	о
қабилачилик	о
қабиҳ	с
қабиҳлашмоқ	ф
қабиҳлик	о
қабл	к
қаблалмилод	с
қаблаттарих	с
қабо	о
қабоқ	о
қабоҳат	о,с
қабоҳатли	с	
қабр	о
қабристон	о
қабртош	о
қабул	о
қабулхона	о
қаварилмоқ	ф
қаваринқи	с
қавариш	о
қавариқ	о,с
қавариқли	с
қавармоқ	ф
қавартирмоқ	ф
қавартма	с
қаварчиқ	о
қават	о
қаватига	р
қаватламоқ	ф
қават-қават	с
қавима	с
қавиқ	о
қавиқчи	о
қавл	о
қавм	о
қавм-қариндош	о
қавом	о
қаврак	о
қавс	о
қавсоб	о
қавчин	о
қад	о
қадд	о
қадалмоқ	ф
қадам	о
қадама	с
қадам-бақадам	р
қадамгоҳ	о
қадамжо	о
қадамжой	о
қадамламоқ	ф
қадамли	с
қадамловчи	ф
қадамма-қадам	р
қадамоқ	ф
қадар	к,о
қадарли	к
қадақ	о
қадаҳ	о
қадди-баст	о
қадди-қомат	о
қадим	о,с
қадимги	р
қадимгилар	о
қадимгича	р
қадимда	р
қадимдан	р
қадимий	с
қадимона	с
қадимча	с
қадимшунос	о
қадоқ	о,с
қадоқламоқ	ф
қадоқланмоқ	ф
қадоқли	с
қадоқловчи	о
қадоқчи	о
қадоқчилик	о
қадоқчой	о
қадр	о
қадрдон	о,с
қадрдонлашмоқ	ф
қадрдонлик	о
қадрият	о
қадрламоқ	ф
қадрли	с
қадрсиз	с
қадрсизланмоқ	ф
қадршунос	о
қадршунослик	о
қаер	ол
қаерга	ол
қаергадир	ол
қаерда	ол
қаердаги	ол
қаердадир	ол
қаердан	ол
қаердандир	ол
қаерлик	ол
қаён	ол
қаёқда	ол
қаёқдаги	с
қаёқдадир	ол
қаёқдан	ол
қаёқдандир	ол
қаёққа	ол
қаёққадир	ол
қази	о
қазили	с
қазилма	о
қазимоқ	ф
қазиш	ф
қазишма	о
қазмоқ	ф
қазна	о
қазноқ	о
қазо	о
қазойи	о
қазув	о
қазувчи	ф,о
қазғоқ	о
қай	ол
қайбир	ол
қайга	ол
қайд	о
қайда	ол
қайдам	ф
қайдан	ол
қайилиш	ф
қайилма	о
қайилмоқ	ф
қайин	с,о
қайинбўйин	о
қайинзор	о
қайир	о
қайирма	с
қайирмоқ	ф
қайиш	о
қайишмоқ	ф
қайишқоқ	с
қайиқ	о
қайиқсоз	о
қайиқсозлик	о
қайиқчи	о
қайла	о
қайлиқ	о
қаймоқ	о
қаймоқдон	о
қаймоқланмоқ	ф
қаймоқлашмоқ	ф
қаймоқли	с
қаймоқхўр	о
қаймоқхўрлик	о
қайнама	о
қайнамоқ	ф
қайнана	о
қайната	о
қайнатма	с
қайнатмоқ	ф
қайнаға	о
қайни	о
қайнов	ф
қайноқ	с
қайнсингил	о
қайнэгачи	о
қайралмоқ	ф
қайрамоқ	ф
қайрағоч	о
қайрилиш	ф
қайрилма	с
қайрилмоқ	ф
қайроқ	о,с
қайроқбоз	о
қайроқбозлик	о
қайроқи	с
қайроқтош	о
қайса	о
қайсар	о,с
қайсарланмоқ	ф
қайсарлик	о
қайси	ол
қайсики	б
қайт	о
қайта	р,к
қайтага	р
қайтадан	р
қайтай	м
қайтайин	м
қайталаб	р
қайталамоқ	ф
қайталанмоқ	ф
қайтаман	ф
қайтанга	р
қайтаргич	о
қайтариш	ф
қайтариқ	о
қайтарма	с,о
қайтармоқ	ф
қайтарувчи	ф,о
қайтасан	ф
қайтиб	ф,р
қайтим	о
қайтиш	ф
қайтмас	ф
қайтмоқ	ф
қайтоқ	с
қайтоқи	с
қайчи	о
қайчибарг	о
қайчиламоқ	ф
қайқаймоқ	ф
қайқи	с
қайғу	о
қайғудош	о
қайғуланмоқ	ф
қайғули	с
қайғурмоқ	ф
қайғусиз	с
қала	о
қалай	ол,о
қалайи	о
қалайламоқ	ф
қалайли	с
қалам	о
қалама	с
қаламдон	о
қаламдош	о
қалами	о
қаламкаш	о
қаламоқ	ф
қалампир	о
қалампиргул	о
қалампирмунчоқ	о
қаламрав	о
қаламтарош	о
қаламча	о
қаламқош	о
қаландар	о
қаландарбачча	о
қаландарлик	о
қаландархона	о
қаланмоқ	ф
қаланғи	о
қаланғи-қасанғи	о
қалача	с
қалачи	о
қалашмоқ	ф
қалб	о,с
қалбаки	с
қалбакилаштирмоқ	ф
қалбакилик	о
қалбакичи	о
қалбакичилик	о
қалбан	р
қалбдош	с
қалбий	с
қалблик	о
қалдирамоқ	ф
қалдироқ	с,о
қалдир-қулдур	т
қалдирғоч	о
қалин	с,о
қалинламоқ	ф
қалинлатмоқ	ф
қалинлашмоқ	ф
қалинлаштирмоқ	ф
қалинлик	о
қалинчи	о
қаллиқ	о
қаллоб	о
қаллоблик	о
қаллобчилик	о
қалмоқ	о
қалмоқи	с
қалмоқлар	о
қалмоқча	с
қалов	ф
қалоқ	о
қалпоқ	о
қалпоқдор	с
қалпоқдўз	о
қалпоқли	с
қалпоқчи	о
қалтилламоқ	ф
қалтирама	с
қалтирамоқ	ф
қалтиранмоқ	ф
қалтироқ	о
қалтис	с
қалт-қалт	т
қалъа	о
қалъачи	о
қалқимоқ	ф
қалқмоқ	ф
қалқовуч	о
қалқон	о
қалқонча	о
қалқувчан	с
қамал	о
қамалишмоқ	ф
қамалмоқ	ф
қамамоқ	ф
қамар	о
қамария	о
қамашмоқ	ф
қамич	о
қамиш	о
қамишзор	о
қамишзорлик	о
қамишқулоқ	о
қамоқ	о
қамоқхона	о
қамрамоқ	ф
қамров	о
қамти	р
қамчи	о
қамчиламоқ	ф
қамчилашмоқ	ф
қамчин	о
қамчинламоқ	ф
қамғоқ	о
қанақа	ол
қанақанги	ол
қанақаси	ол
қанақасига	р
қанд	о
қанда	ол
қандай	ол
қандайдир	ол
қандак	с
қандалалар	о
қандалат	о
қандақа	ол
қандағоч	о
қанддай	с
қанддек	с
қанддон	о
қандил	о
қандим	о
қандин	с
қандлар	о
қандли	с
қандолат	о
қандолатфуруш	о
қандолатчи	о
қандолатчилик	о
қандоқ	ол
қандчой	о
қанд-қурс	о
қанжир	о
қанжирға	о
қанжиға	о
қанжиқ	о
қанзимоқ	ф
қани	ол
қаноат	о
қаноатланарли	с
қаноатланарсиз	с
қаноатланмоқ	ф
қаноатлантирарли	с
қаноатли	с
қаноатсиз	с
қанор	о
қанора	о
қанорламоқ	ф
қанот	о
қанотланмоқ	ф
қанотли	с
қанот-қуйруқ	о
қантар	о
қантариқ	о
қантариғлиқ	с,с
қантарламоқ	ф
қантармоқ	ф
қанча	ол,р,б
қанчадан-қанча	сн
қанчалик	б
қаншар	о
қанқаймоқ	ф
қанқимоқ	ф
қапишмоқ	ф
қаппаймоқ	ф
қапчимоқ	ф
қараганда	к
қараим	о
қараимлар	о
қаралмиш	о
қарам	с
қарамай	ф
қарамасдан	ф
қарама-қарши	с
қарама-қаршилик	о
қарамлик	о
қарамоқ	ф
қарамоғ	о
қаранмоқ	ф
қарата	к
қаратилмоқ	ф
қаратмоқ	ф
қаратқи	о
қаратқич	с
қараш	ф
қарашли	к
қарашмоқ	ф
қарағай	о
қарағайзор	о
қардош	с
қардошларча	р
қардошлик	о
қарз	о
қарздор	о
қарз-қавола	о
қарз-қурз	о
қари	с,о
қарийб	р
қарилик	о
қарилламоқ	ф	
қаримоқ	ф
қаримсиқ	с
қаримта	о
қаримтали	с
қариндош	о
қариндошлик	о
қариндош-уруғ	о
қариндошчилик	о
қарич	о
қаричламоқ	ф
қариш	о
қаришқул	о
қария	о
қари-қартанг	о
қариқиз	о
қарлуқлар	о
қармамоқ	ф
қармоқ	о
қаро	с
қаробат	о
қаров	ф
қаровсиз	с
қаровсизлик	о
қарол	о
қароллик	о
қарор	о
қарорбозлик	о
қароргоҳ	о
қарорсиз	с,р
қарорсизланмоқ	ф
қароқчи	о
қароқчилик	о
қароғ	о
қарр	т
қарс	т
қарсак	о
қарсакбозлик	о
қарсакчи	о
қарсилламоқ	ф
қарсиллатмоқ	ф
қарсоқ	о
қарт	с
қарта	о
қартабоз	о
қартабозлик	о
қартаймоқ	ф
қартанг	о
қарт-қурт	т
қарчиғай	о
қарши	с
қаршиламоқ	ф
қаршилашмоқ	ф
қаршилик	о
қаршима-қарши	с
қарқара	о
қарқуноқ	о
қарға	о
қарғажийда	о
қарғамоқ	ф
қарғанмоқ	ф
қарғаш	ф
қарғашмоқ	ф
қарғашойи	о
қарғиш	о
қарғишламоқ	ф
қасава	о
қасам	о
қасамёд	о
қасамхўр	о
қасанғи	с
қасд	о
қасдан	р
қасддан	р
қасддор	с
қасдланмоқ	ф
қасдлашмоқ	ф
қасдма-қасдга	р
қасдма-қасдига	р
қасида	о
қасидагўй	о
қасиданавис	о
қасидачи	о
қасир	т,с
қасира-қусур	т
қасирламоқ	ф
қасир-қусур	т
қасирға	о
қасмоқ	ф
қасмоқламоқ	ф
қасос	о
қасоскор	о
қасосли		с
қасосчи	о
қаср	о
қассоб	о
қассоблик	о
қассобчилик	о
қасқон	о
қат	о,ол
қаталоқ	о
қатағон	о
қатим	о
қатимламоқ	ф
қатирма	о
қатирмаланмоқ	ф
қатирмоч	с
қатиқ	о
қатиқламоқ	ф
қатиқли	с
қатиқсиз	с
қатиқфуруш	о
қатиқчи	о
қатл	о
қатла	к
қатлам	о
қатлама	о
қатламламоқ	ф
қатламли	с
қатламоқ	ф
қатлам-қатлам	с
қатланмоқ	ф
қатлгоҳ	о
қатма-қат	с
қатнамоқ	ф
қатнашмоқ	ф
қатнашувчи	ф,о
қатнашчи	о
қатнов	ф,о
қатор	о
қаторасига	р
қаторламоқ	ф
қаторлашмоқ	ф
қаторлаштирмоқ	ф
қаторма-қатор	р
қатор-қатор	с
қатра	о
қатрон	о
қатронламоқ	ф
қаттиқ	с
қаттиқламоқ	ф
қаттиқлашмоқ	ф
қаттиқлик	о
қаттиқчилик	о
қаттиқ-қурум	с
қаттиқ-қуруқ	с
қаттиққўл	с
қаттиққўллик	о
қаттол	о
қат	о,ол
қатъ	о
қатъан	р
қатъий	с
қатъийлашмоқ	ф
қатъийлик	о
қатъийян	р
қатъийят	о
қатъиятли	с
қатъиятсиз	с
қатъиятсизлик	о
қатқалоқ	о
қатқалоқланмоқ	ф
қат-қат	с
қатқорин	о
қафас	о
қачон	ол
қачонги	ол
қачондир	р
қачонки	б
қачонлар	р
қашимоқ	ф
қашламоқ	ф
қашлағич	о
қашов	о
қашшанг	с
қашшоқ	с
қашшоқланмоқ	ф
қашшоқлашмоқ	ф
қашшоқлик	о
қашқа	о
қашқалдоқ	о
қашқали	с
қашқарбеда	о
қашқарболдоқ	о
қашқаргул	о
қашқари	с
қашқарча	с,о
қашқир	о
қаъда	о
қаър	о
қақажон	с
қақаноқ	о
қақас	с
қақаламоқ	ф
қақақламоқ	ф
қақилдоқ	с
қақилламоқ	ф
қақир	с
қақирламоқ	ф
қақир-қуқур	о
қақоламоқ	ф
қақрамоқ	ф
қақроқ	с
қақшамоқ	ф
қақшатмоқ	ф
қақшатқич	с
қақшоқ	с
қаққаймоқ	ф
қақ-қақ	т
қағ	т
қағаноқ	о
қағилламоқ	ф
қаҳат	о
қаҳатчилик	о
қаҳва	о
қаҳвахона	о
қаҳвачи	о
қаҳр	о
қаҳрамон	о
қаҳрамонлик	о
қаҳрамонона	р
қаҳратон	с
қаҳрланмоқ	ф
қаҳрли	с
қаҳ-қаҳ	т
қаҳқаҳа	о
қаҳқаҳаламоқ	ф
қаҳқаҳламоқ	ф
қаҳқаҳалашмоқ	ф
қаҳқаҳлашмоқ	ф
қибла	о
қиблагоҳ	о
қибланамо	о
қидириш	ф
қидиришмоқ	ф
қидирмоқ	ф
қидирув	о
қиё	р
қиёламоқ	ф
қиём	о
қиёмат	о
қиёматгача	р
қиёматли	с
қиёмат-қойим	о
қиёс	о
қиёсан	р
қиёсий	с
қиёсламоқ	ф
қиёссиз	с
қиёт	о
қиёфа	о
қиёфали	с
қиёфат	о
қиёфатли	с
қиёқ	о
қиёқзор	о
қиз	о
қизалоқ	о
қизамиқ	о
қизаринмоқ	ф
қизаринқирамоқ	ф
қизаришмоқ	ф
қизармоқ	ф
қизартирмоқ	ф
қизартмоқ	ф
қиздиргич	о
қиздирилмоқ	ф
қиздирмоқ	ф
қиз-жувонлар	о
қизил	с
қизилбош	о
қизилиштон	о
қизиллик	о
қизилмағиз	с
қизилмия	о
қизилоёқ	о
қизилуруғ	о
қизилча	о
қизилўнгач	о
қизилқуйруқ	о
қизимоқ	ф
қизиталоқ	о
қизитмоқ	ф
қизишмоқ	ф
қизиқ	с
қизиқарли	с
қизиқиш	ф
қизиқмоқ	ф
қизиқсинмоқ	ф
қизиқтирмоқ	ф
қизиқувчан	с
қизиқувчанлик	о
қизиқчи	о
қизиқчилик	о
қизиққон	с
қизиққонли	с
қизиққонлик	о
қизиғар	о
қизкўрар	о
қизли	с
қизлик	о,с
қизоши	о
қизталоқ	о
қизувчан	с
қизча	о
қизчиқарар	о
қизқуш	о
қизғалдоқ	о
қизғанмоқ	ф
қизғанч	о
қизғанчиқ	с
қизғанчиқлик	о
қизғанчоқ	с
қизғар	о
қизғимтир	с
қизғин	с
қизғинлашмоқ	ф
қизғинлик	о
қизғиш	с,о
қий	о,т
қийилламоқ	ф
қийилмоқ	ф
қийин	с
қийинди	о
қийинлашмоқ	ф
қийинлик	о
қийинчилик	о
қийинчилисиз	с
қийин-қистов	о
қийин-қистоқ	о
қийишмоқ	ф
қийиқ	о
қийиқлик	о,с
қийиқча	о
қийма	о
қиймаламоқ	ф
қиймали	с
қиймат	о
қийматахта	о
қийматбаҳо	с
қийматли	с
қийматшунос	о
қийма-қийма	о
қиймоқ	ф
қийналиш	ф
қийналмоқ	ф
қийнамоқ	ф
қийнаш	ф
қийнов	ф
қийноқ	о
қийноқли	с
қийноқхона	о
қийноқ-қистоқ	о
қийпангламоқ	ф
қийпичоқ	с
қийратмоқ	ф
қийрихон	с,р
қийтим	с
қийтиқ	о
қий-чув	о
қийчувлашмоқ	ф
қийшаймоқ	ф
қийшангламоқ	ф
қийшанғи	с
қийшиқ	с
қийшиқ-туйшиқ	с
қийқ	т
қийқанламоқ	ф
қийқилламоқ	ф
қийқим	о
қийқинди	о
қийқириш	ф
қийқиришмоқ	ф
қийқириқ	о
қийқирмоқ	ф
қийқироқ	с
қийқиртирмоқ	ф
қийғилламоқ	ф
қийғир	о
қийғос	р
қийғоч	с
қил	о
қилвир	с
қилвирлик	о
қилдай	с
қилдирмоқ	ф
қилич	о
қиличбоз	о
қиличбозлик	о
қиличбоғ	о
қиличдай	с
қилиш-қилмиш	о
қилиқ	о
қилкўприк	о
қилмиш	о
қилмоқ	ф
қилпангламоқ	ф
қилпанғи	о
қилпилламоқ	ф
қилт	т
қилтаб	с
қилтангламоқ	ф
қилтаноқ	о
қилтилламоқ	ф
қилтириқ	о,с
қилтиқ	о
қилтомоқ	о
қилуқол	о
қилча	о,сн
қилчалик	сн
қилчилвир	о
қилқалам	о
қилқилламоқ	ф
қилғилик	о
қимиз	о
қимизак	с
қимизхўр	с
қимизхўрлик	о
қимир	т
қимирламоқ	ф
қимирлатмоқ	ф
қимир-қимир	о
қиммат	с,о
қимматбаҳо	с
қимматланмоқ	ф
қимматлашмоқ	ф
қимматли	с
қимматсиз	с
қимматсизланмоқ	ф
қимматсирамоқ	ф
қимматфуруш	о
қимматчилик	о
қимор	о
қиморбоз	о
қиморбозлик	о
қиморхона	о
қимрон	о
қимтамоқ	ф
қимти	с
қимтилмоқ	ф
қимтимоқ	ф
қимтинмоқ	ф
қимчимоқ	ф
қин	о
қинғаймоқ	ф
қинғир	с
қирғирлик	о
қирғир-қийшиқ	с
қипиқ	о
қипчоқ	о
қипчоқлар	о
қип-яланғоч	с
қип-қизил	с
қир	о,т
қирилишмоқ	ф
қирилмоқ	ф
қиринди	о
қириштирмоқ	ф
қирлик	о
қирма	с
қирмачи	о
қирмизак	с
қирмиз	с
қирмизи	с
қирмиска	с
қирмоч	о
қирмоқ	ф
қироат	о
қироатхон	о
қироатхона	о
қироатхонлик	о
қироатчилик	о
қиров	о
қировламоқ	ф
қировли	с
қирол	о
қиролича	о
қироллик	о
қирон	о
қиронгарчилик	о
қирончилик	о
қиронқарға	о
қиронқора	о
қирпи	с
қирпичоқ	о
қирр	т
қирра	о
қиррабурун	о
қиррадор	с
қирраламоқ	ф
қиррали	с
қирриқ	с
қирс	т
қирсилламоқ	ф
қирсиллатмоқ	ф
қирс-қирс	т
қирт	т
қиртилламоқ	ф
қиртиллатмоқ	ф
қиртишламоқ	ф
қирт-қирт	т
қирувчи	ф
қирчанғи	с
қирчиллама	с
қирчилламоқ	ф
қирчимоқ	ф
қирчин	с
қирқ	сн
қирқбўғин	о
қирқбўғим	о
қирқилмоқ	ф
қирқим	о
қир-қир	т
қирқиқ	с
қирқкокил	сн
қирқма	с
қирқмоқ	ф	
қирқоёқ	о
қирқоғайни	о
қирққулоқ	о
қирғи	о
қирғиз	о
қирғизлар	о
қирғизча	с,о
қирғий	о
қирғин	о
қирғинбарот	о
қирғин-сурон	о
қирғинчи	о
қирғинчилик	о
қирғич	о
қирғияк	о
қирғовул	о
қирғоқ	о
қирғоқлаб	р
қисакўз	с
қисатмоқ	ф
қисиб-қимтиб	р
қисилмоқ	ф
қисим	о
қисимламоқ	ф
қисинмоқ	ф
қисинқи	с
қисинқилик	о
қисир	с,т
қисирламоқ	ф
қисирлатмоқ	ф
қисир-қисир	т
қисиқ	с
қисм	о
қисма	с
қисман	р
қисмат	о
қисмоқ	ф
қисса	о
қиссагўй	о
қиссагўйлик	о
қиссанавис	о
қиссанавислик	о
қиссахон	о
қиссахонлик	о
қиссачи	о
қиссачилик	о
қисталанг	с
қисталанглик	о
қисталоқ	о
қистамоқ	ф
қистангламоқ	ф
қистатмоқ	ф
қисти-басти	о
қистириқлик	с
қистирма	о
қистирмоқ	ф
қистир-қистир	о
қистирғич	о
қистов	ф,о
қистовли	с
қистоқ	о
қистоқламоқ	ф
қисув	о
қисқа	с
қисқаймоқ	ф
қисқалик	о
қисқармоқ	ф
қисқартирмоқ	ф
қисқартма	о
қисқартмоқ	ф
қисқаси	с
қисқача	с
қисқич	о
қисқичбақа	о
қитдай	р
қитдек	р
қитилламоқ	ф
қитир	т
қитирламоқ	ф
қитир-қитир	т
қитиқ	о
қитиқлагич	о
қитиқламоқ	ф
қитиқли	с
қитиқловчи	ф
қитмир	с
қитмирлик	о
қиттай	сн,р
қиттак	сн,р
қитъа	о
қих	т
қиха	с
қихқихламоқ	ф
қичамоқ	ф
қичима	о
қичимоқ	ф
қичинмоқ	ф
қичитмоқ	ф
қичитқи	с
қичиш	о
қичишмоқ	ф
қичиқ	о
қичиқлик	о
қичов	о
қичқириқ	о
қичқирмоқ	ф
қиш	о
қишин-ёзин	р
қишки	с
қишламоқ	ф
қишлик	с,о
қишлов	ф
қишлоқ	о
қишлоқи	с
қишлоқлик	о
қишлоқча	о
қишлоқчилик	о
қиш-қировли
қия	о,с
қиялама	с
қияламоқ	ф
қияланмоқ	ф
қиялик	о
қияма	о
қиямалик	о
қиячил	с
қиқангламоқ	ф
қиқилламоқ	ф
қиқир	т
қиқирламоқ	ф
қиқир-қиқир	т
қиғилламоқ	ф
қиғ-қиғ	т
қобил	с,о
қобилият	о
қобилиятли	с
қобилиятсиз	с
қобиллашмоқ	ф
қобиллик	о
қобирға	о
қобиқ	о
қобон	о
қов	о
қовжирамоқ	ф
қовжиратмоқ	ф
қовжироқ	с
қовзанмоқ	ф
қовзоқ	о
қовочак	о
қовоқ	о
қовоқ-димоқ	о
қовоқдошлар	о
қовоқ-тумшуқ	о
қовоқхона	о
қовоқхоначи	о
қовоғари	о
қоврилмоқ	ф
қовуз	о
қовузлоқ	о
қовузоқ	о
қовузғоқ	о
қовул	о
қовун	о
қовункапа	о
қовунхўр	с
қовунхўрлик	о
қовунчи	о
қовунчилик	о
қовунқоқи	о
қовурдоқ	о
қовурилмоқ	ф
қовурма	с
қовурмоқ	ф
қовуртирмоқ	ф
қовурға	о
қовушимли	с
қовушимсиз	с
қовушиқли	с
қовушма	о
қовушмоқ	ф
қовушоқ	с
қовушоқлик	о
қовуштирмоқ	ф
қовушқоқ	с
қовуқ	о
қовға	о
қодир	с,о
қодирлик	о
қози	о
қозибоз	о
қозибозлик	о
қозивачча	о
қозизода	о
қозикалон	о
қозилашмоқ	ф
қозилик	о
қозихона	о
қозиқ	о
қозиққулоқ	о
қозон	о
қозонаки	с
қозонкабоб	о
қозонмоқ	ф
қозон-товоқ	о
қозонхона	о
қозонча	о
қозончи	о
қозоқ	о,с
қозоқи	с
қозоқлар	о
қозоқча	о
қоида	о
қоидабузарлик	о
қоидалашмоқ	ф
қоидалаштирмоқ	ф
қоим	р,с
қоиммақом	с
қойил	с
қойиллатмоқ	ф
қойилмақом	с
қойим	р,с
қолган-қутган	с
қолдирилмоқ	ф
қолдирмоқ	ф
қолдиқ	о
қолип	о
қолипаки	о
қолипламоқ	ф
қолипловчи	о
қолипчи	о
қолишмоқ	ф
қолмоқ	ф
қолоқ	с
қолоқлик	о
қомат	о
қоматдор	с
қоматли	с
қомус	о
қомусчи	о
қон	о
қонамоқ	ф
қондирмоқ	ф
қондош	о
қониқарли	с
қониқарсиз	с
қониқиш	ф,о
қониқмоқ	ф
қониқтирмоқ	ф
қониққувлик	с
қонламоқ	ф
қонли	с
қонлиқ	о
қонмоқ	ф
қонсиз	с
қонсизланмоқ	ф
қонсизлик	о
қонсирамоқ	ф
қонталаб	с
қонталаш	с
қонталашмоқ	ф
қонун	о
қонунан	с
қонунбузар	о
қонунбузарлик	о
қонуний	с
қонунийлик	о
қонуният	о
қонунлашмоқ	ф
қонунлаштирмоқ	ф
қонунли	с
қонунсиз	с
қонунсизлик	о
қонунчилик	о
қонуншунос	о
қонуншунослик	о
қонхўр	с
қонхўрлик	о
қон-қариндош	о
қон-қариндошлик	о
қон-қариндош	о
қоп	о
қопағон	с
қопи	о
қопинмоқ	ф
қоплам	о
қоплама	о,с
қопламоқ	ф
қопланмоқ	ф
қопловчи	ф,о
қоплон	о
қопмоқ	ф
қопонғич	с
қоптирмоқ	ф
қопу	о
қопча	о
қопчиқ	о
қопқа	о
қопқон	о
қоп-қоп	сн
қоп-қоронғи	с
қопқоқ	о
қопқоқламоқ	ф
қопқоқли	с
қор	о
қора	с,о
қораандиз	о
қораарча	о
қорабайир	о
қорабалиқ	о
қорабарак	о
қорабовур	о
қорабош	о
қорабузов	о
қорабура	о
қорабуғдой	о
қоравой	о
қорагул	о
қорадори	о
қоражанжал	о
қоражигар	о
қорайиш	о
қораймоқ	ф
қорайтирмоқ	ф
қоракалтак	о
қоракаш	с
қоракесак	о
қоракосов	о
қоракуя	о
қоракўза	о
қоракўл	о
қоракўлчи	о
қоракўлчилик	о
қоралама	о
қораламоқ	ф
қоралик	о
қораловчи	ф,о
қорамалдоқ	о
қорамашоқ	о
қорама-қора	р
қорамағиз	с
қорамиқ	о
қорамой	о
қорамол	о
қорамолчилик	о
қорамтир	с
қорамуғ	о
қорапатак	о
қорапўчоқ	о
қорасовуқ	о
қорасон	о
қорасувоқ	о
қорасули	о
қоратол	о
қоратомоқ	о
қоратўр	с
қоратўри	с
қорача	с,о
қорачакак	о
қорачирик	о
қорачироқ	о
қорачиқ	о
қорачойлар	о
қорашақшақ	о
қорашўра	о
қораялоқ	о
қорақайин	о
қорақалпоқ	о,с
қорақалпоқлар	о
қорақанд	о
қорақарғай	о
қорақарға	о
қорақат	о
қорақиёқ	о
қорақовуқ	о
қорақош	о
қорақуйруқ	о
қорақулоқ	о
қорақурт	о
қорақуш	о
қорақўтир	о
қорбўрон	о
қоргич	о
қорёғди	о
қори	о
қорилик	о
қорилмоқ	ф
қорин	о
қоринбой	с
қоринбоғ	о
қоринбоғич	о
қориндор	с
қоринли	с
қоринча	о
қорихона	о
қоришиқ	с
қоришма	о
қоришмоқ	ф
қориштирмоқ	ф
қориқ	о
қориқчи	о
қорли	с
қорлик	о
қормоқ	ф
қоровул	о
қоровулбеги	о
қоровулламоқ	ф
қоровуллик	о
қоровулхона	о
қоровулчилик	о
қоронғи	с,о
қоронғизор	о
қоронғиламоқ	ф
қоронғилатмоқ	ф
қоронғилашмоқ	ф
қононғилик	о
қоротқи	с
қортиқ	о
қорув	о
қорувли	с
қорхат	о
қосид	о
қосир	с
қотил	о
қотиллик	о
қотилмоқ	ф
қотинмоқ	ф
қотирма	с
қотирмоқ	ф
қотишма	о
қотишмоқ	ф
қотма	с
қотмоқ	ф
қотранғи	о
қотқоқ	о
қоф	о
қофила	о
қофия	о
қофиябоз	о
қофиябозлик	о
қофиядош	с
қофиядошлик	о
қофияламоқ	ф
қофияланмоқ	ф
қофияли	с
қочилмоқ	ф
қочирим	о
қочириш	о
қочириқ	о
қочирма	о
қочирмоқ	ф
қочиқ	о
қочмоқ	ф
қочоқ	о
қочқин	о
қочқинлик	о
қочқинчи	о
қочқир	с
қоч-қоч	о
қочқоқ	с
қош	о
қошидаги	к
қошиқ	о
қошиқдон	о
қошиқламоқ	ф
қошиқчи	о
қошиқчилик	о
қош-қовоқ	о
қоя	о
қоягирлик	о
қоятош	о
қоқ	с,ю
қоқвош	с
қоқи	о
қоқилмоқ	ф
қоқим	о
қоқимчи	о
қоқиндиқ	о
қоқинмоқ	ф
қоқирим	о
қоқишмоқ	ф
қоқиштирмоқ	ф
қоқламоқ	ф
қоқмоқ	ф
қоқтирмоқ	ф
қоқшол	с
қоғоз	о
қоғозбоз	о
қоғозбозлик	о
қоғозжилд	о
қоғоноқ	о
қубба	о
қуббали	с
қуббача	о
қубур	о
қув	с,о,р,у
қуваламоқ	ф
қувалашмоқ	ф
қувбош	с
қувва	о
қувват	о
қувватламоқ	ф
қувватланмоқ	ф
қувватли	с
қувватсиз	с
қувватсизланмоқ	ф
қувватсизлик	о
қувилмоқ	ф
қувишмоқ	ф
қувиштирмоқ	ф
қувламоқ	ф
қувланмоқ	ф
қувлашмачоқ	о
қувлашмоқ	ф
қувлик	о
қувмоқ	ф
қувнамоқ	ф
қувноқ	с
қувноқлик	о
қувонмоқ	ф
қувонч	о
қувончиқ	о
қувончли	с
қуврай	о
қуврамоқ	ф
қувроқ	с
қувур	о
қувғун	о
қувғунди	о
қуда	о
қуда-анда	о
қуда-андали	с
қуда-андалик	о
қуда-андачилик	о
қудалашмоқ	ф
қудалик	о,с
қудача	о
қудачилик	о
қуда-қудағай	о
қудағай	о
қудрат	о
қудратбахш	с
қудратли	с
қудуқ	о
қуён	о
қуёнхона	о
қуёнчилик	о
қуёнчиқ	о
қуёш	о
қуёшлама	о
қуёшли	с
қузғун	о
қуйи	о,с
қуйида	р
қуйидаги	с
қуйилиш	ф
қуйилма	о
қуйилмоқ	ф
қуйиш	ф
қуйма	с
қуймоқ	ф
қуймуч	о
қуйруқ	о
қуйруқчи	о
қуйқа	о
қуйқинди	о
қуйқум	о
қул	о
қула	с
қулай	с
қулайлашмоқ	ф
қулайлик	о
қулайсиз	с
қулайсизлик	о
қуламоқ	ф
қулатмоқ	ф
қула-туз	о
қулвачча	о
қулдор	о
қулдорлик	о
қулдурамоқ	ф
қулдур-қулдур	т
қулжаллоб	о
қулларча	р
қуллик	о
қуллоб	о
қуллуқ	м
қулмоқ	о
қулон	о
қулон-туз	о
қулоч	о,с
қулочкаш	о
қулочкашлаб	р
қулочлаб	р
қулочламоқ	ф
қулоқ	о
қулоқдош	о
қулоқлашмоқ	ф
қулоқли	с
қулоқлик	о
қулоқма-қулоқ	р
қулоқ-мия	о
қулоқсиз	с
қулоқчин	о
қулоқчўзма	о
қулп	т
қулт	т
қултилламоқ	ф
қултиллатмоқ	ф
қултум	о
қулт-қулт	р
қулун	о
қулунламоқ	ф
қулунли	с
қулунтой	о
қулунчоқ	о
қулупнай	о
қулф	о
қулф-калит	о
қулфламоқ	ф
қулфли	с
қулфлоқ	с
қулфлоқлик	с
қулфсиз	с
қулфуруш	о
қулфчи	о
қулча	о,р
қулчилик	о
қулқул	о
қул-қул	т
қулқулламоқ	ф
қулқулум	о
қулқ-улқ	т
қулғуна	о
қум	о,т
қумаламоқ	ф
қумалоқ	о
қуманжир	о
қумзор	о
қумламоқ	ф
қумли	с
қумлик	о
қумлоқ	о
қумой	о
қумош	о
қумоқ	с
қумоқ-қумоқ	с
қумпиёз	о
қумри	о
қумсабзи	о
қумсақич	о
қумтош	о
қумурсқа	о
қумурсқадай	с,сн
қумурсқадек	с,сн
қум-қум	сн
қумғон	о
қундуз	о
қундузи	с
қунишмоқ	ф
қунт	о
қунтли	с
қунтсиз	с
қуп-қуруқ	с
қуппа-қуруқ	с
қур	о,к,т
қурай	у
қурайлаб	р
қуралай	о
қурама	с
қурамоқ	ф
қурб	о
қурбақа	о
қурбон	о
қурбонлик	о
қургур	о
қурдош	о
қурдум	с
қурей	у
қурейламоқ	ф
қурилдоқ	с
қурилиш	ф,о
қурилламоқ	ф
қурилма	о
қурилмоқ	ф
қуримоқ	ф
қуритгич	о
қуритилмоқ	ф
қуритмоқ	ф
қуриш	ф
қурма	о
қурмагур	о
қурмакорлик	о
қурмағур	о
қурмоқ	ф
қуров	о
қурол	о
қуролбардор	о
қуролдош	о
қуролланмоқ	ф
қуроллантирмоқ	ф
қуролли	с
қуролсиз	с
қуролсизланмоқ	ф
қуролсиз	о
қуролхона	о
қурол-яроғ	о
қуроқ	о,с
қуроқзор	о
қурро	о
қурсоқ	о
қурт	о
қуртава	о
қуртдай	р,с
қуртдек	р,с
қуртламоқ	ф
қуртли	с
қуртлоқи	с
қуртхона	о
қуртчи	о
қуртчилик	о
қурт-қумурсқа	о
қурувчи	ф
қурултой	о
қурум	о
қурумли	с
қурумсоқ	с
қурумсоқлик	о
қуруқ	c
қурутчи	о
қурушиқ	с
қурушмоқ	ф
қурушоқ	с
қурушқоқ	с
қуруқ	с
қуруқдан-қуруқ	р
қуруқлик	о
қуруқчилик	о
қуруқшамоқ	ф
қурч	о,с
қурчоқ	о
қурчоқбоз	о
қуршалмоқ	ф
қуршамоқ	ф
қуршов	о
қуръа	о
қуръаандоз	о
қуръон	о
қур-қур	р
қурқурамоқ	ф
қурғамоқ	ф
қурғоқ	с
қурғоқлик	о	
қурғоқчил	с
қурғоқчилик	о
қурғур	с
қусиш	ф
қусмоқ	ф
қусур	о
қусурли	с
қусурсиз	с
қусуқ	о
қут	о
қутб	о
қут-барака	о
қут-баракали	с
қутбий	с
қутбланиш	о
қутбчи	о
қути	о
қутидор	о
қутидорлик	о
қутича	о
қутламоқ	ф
қутлашмоқ	ф
қутли	с
қутлов	ф,о
қут-лоямут	о
қутлуғ	с,о
қутлуғламоқ	ф
қутсиз	с
қутулмоқ	ф
қутуриш	ф
қутурмоқ	ф
қутуртирмоқ	ф
қутқазмоқ	ф
қутқариш	ф
қутқармоқ	ф
қутқарувчи	ф,о
қутқу	о
қучмоқ	ф
қучоқ	о
қучоқламоқ	ф
қучоқлашмоқ	ф
қуш	о
қушбеги	о
қушбоз	о
қушбурун	о
қушдай	с,р
қушдек	с,р
қушноч	о
қуштили	о
қуштомоқ	о
қушхона	о
қушчилик	о
қушқароқ	о
қушқўнмас	о
қуювчи	ф
қуюлмоқ	ф
қуюлтирмоқ	ф
қуюн	о
қуюшқон	о
қуюқ	с
қуюқлашмоқ	ф
қюқлаштирмоқ	ф
қуюқ-суюқ	о
қу-қу	т
қуқуламоқ	ф
қуқ-қуқ	т
қўбиз	о
қўбизчи	о
қўзи	о
қўзивой	о
қўзидумба	о
қўзиламоқ	ф
қўзилатиш	о
қўзилатмоқ	ф
қўзимоқ	ф
қўзичоқ	о
қўзиқорин	о
қўзиқулоқ	о
қўзоқ	о
қўзғалиш	о
қўзғалишмоқ	ф
қўзғалмоқ	ф
қўзғалувчан	с
қўзғамоқ	ф
қўзғатмоқ	ф
қўзғовчи	ф
қўзғолон	о
қўзғолончи	о
қўй	о
қўйбоши	о
қўйдирмоқ	ф
қўйди-чиқди	о
қўйилмоқ	ф
қўйин	о
қўйингки	м
қўйингчи	м
қўйли	с
қўймоқ	ф
қўйпечак	о
қўйтикан	о
қўйфуруш	о
қўйхона	о
қўйчи	о
қўйчивон	о
қўйчилик	о
қўл	о
қўланса	c,о
қўлансимоқ	ф
қўлантаёқ	р
қўлбола	с
қўлбоғ	о
қўлдош	о
қўлёзма	о
қўллаб	ф
қўллаб-қувватламоқ	ф
қуллаб-қултиқлатоқ	ф
қўлламоқ	ф
қўлланма	о
қўллашмоқ	ф
қўлли	с
қўлли-оёқли	с
қўлма-қўл	р
қўл-оёқ	о
қўл-оёқли	о
қўлсиз	с
қўлтиқ	о
қўлтиқбардор	о
қўлтиқламоқ	ф
қўлтиқлатмоқ	ф
қўлтиқлашмоқ	ф
қўлтиқтаёқ	о
қўлтиқтумор	о
қўлқанот	о
қўлқоп	о
қўм	о
қўмита	о
қўмиқлар	о
қўмламоқ	ф
қўмондон	о
қўмондонлик	о
қўмсамоқ	ф
қўмсаш	ф
қўналға	о
қўнарли	с
қўндирилмоқ	ф
қўндирмоқ	ф
қўндоқ	о
қўндоқламоқ	ф
қўнж	о
қўнжли	с
қўним	о
қўнимлик	о
қўнимсиз	с
қўнимсизлик	о
қўниш	ф
қўнишмоқ	ф
қўни-қўшни	о
қўни-қўшничилик	о
қўнмоқ	ф
қўнолға	о
қўноқ	о
қўноқламоқ	ф
қўноқлик	о,с
қўноқхона	о
қўноқчи	о
қўнқаймоқ	ф
қўнқайтирмоқ	ф
қўнғиз	о
қўнғир	с
қўнғирбош	о
қўнғирот	о
қўнғироқ	о,с
қўнғироқгул	о
қўнғироқли	с
қўпмоқ	ф
қўпол	с
қўполлашмоқ	ф
қўполлик	о
қўпорилмоқ	ф
қўпормоқ	ф
қўпорувчи	о
қўпорувчилик	о
қўр	о
қўра	о
қўрамта	о
қўрбоши	о
қўримоқ	ф
қўриқ	о
қўриқламоқ	ф
қўриқхона	о
қўриқчи	о
қўриқчилик	о
қўрс	с
қўрслик	о
қўрхона	о
қўрчи	о
қўрқа-писа	р
қўрқарли	с
қўрқимсирамоқ	ф
қўрқинч	о
қўрқинчли	с
қўрқинчсиз	с
қўрқинқирамоқ	ф
қўрқитиш	о
қўрқитмоқ	ф
қўрқиш	ф
қўрқмас	ф
қўрқмоқ	ф
қўрқоқ	с
қўрқоқлик	о
қўрқув	о
қўрқувли	с
қўрқувсиз	с
қўр-қут	о
қўрққулик	с
қўрғаламоқ	ф
қўрғамоқ	ф
қўрғон	о
қўрғонбеги	о
қўрғонча	о
қўрғошин	о
қўрғошинли	с
қўсқи	с,о
қўтир	о
қўтон	о
қўтонлаб	сн
қўтонламоқ	ф
қўтос	о
қўчқор	о
қўчқорбоз	о
қўш	с
қўша	с
қўшалоқ	с
қўшалоқламоқ	ф
қўша-қўша	сн
қўшбеги	о
қўшбош	с
қўшиб-чатиб	р
қўшилишмоқ	ф
қўшилма	о
қўшилмоқ	ф
қўшилувчи	ф,о
қўшимча	с,о
қўшин	о
қўшиш	ф
қўшиқ	о
қўшиқчи	о
қўшиқчилик	о
қўшма	с
қўшмачи	о
қўшмачилик	о
қўшметалл	с
қўшмисра	о
қўшмозор	о
қўшмоқ	ф
қўшнай	о
қўшнайчи	о
қўшни	о
қўшничилик	о
қўшовоз	о,с
қўшоёқ	о
қўшотар	о
қўшоқ	с
қўшоқламоқ	ф
қўшоғиз	о
қўштабақа	с
қўштабақали	с
қўштавақа	с
қўштавақали	с
қўштирмоқ	ф
қўштирноқ	о
қўштиғ	с
қўштор	с
қўштуёқлилар	о
қўшув	ф,о
қўшхона	о
қўшчаноқ	о
қўшчи	о
қўшчи-қўлончи	о
қўшқават	с
қўшқаватли	с
қўшқанот	с
қўшқанотли	с
қўшқулоқ	о
қўш-қўш	сн
қўша-қўша	сн
қўярда-қўймай	р
қўқонарава	о
қўқонгул	о
қўқонжўхори	о
қўққаймоқ	ф
қўққайтирмоқ	ф
қўққисдан	р
қўға	о
қўғазор	о
қўғай	о
қўғирмоч	о
қўғирмоқ	ф
қўғирчоқ	о
қўғирчоқбоз	о
қўғирчоқбозлик	о
қўғирчоқдай	с
қўғирчоқдек	с